そうです	"That's right."	Genki lesson-1 Part_2 Vocabulary
そうですか	I see.; Is that so?	Genki lesson-1 Part_2 Vocabulary
～ねんせい	...year student	Genki lesson-1 Part_2 Vocabulary
かんこく	Korea	Countries Genki lesson-1 Vocabulary
アジアけんきゅう	Asian studies	Genki lesson-1 Majors Vocabulary
けいざい	economics	Genki lesson-1 Majors Vocabulary
こくさいかんけい	international relations	Genki lesson-1 Majors Vocabulary
じんるいがく	anthropology	Genki lesson-1 Majors Vocabulary
せいじ	politics	Genki lesson-1 Majors Vocabulary
れきし	history	Genki lesson-1 Majors Vocabulary
しゅふ	housewife	Genki lesson-1 Occupations Vocabulary
あいさつ	greeting; greetings	Bonus_Vocabulary Genki lesson-1 Words_in_Genki
れんしゅう	practice; practising	Bonus_Vocabulary Genki lesson-1 Words_in_Genki
おじぎ	bow; bowing	Bonus_Vocabulary Genki lesson-1 Words_in_Genki
だい～か	lesson...	Bonus_Vocabulary Genki lesson-1 Words_in_Genki
たんご	word; vocabulary	Bonus_Vocabulary Genki lesson-1 Words_in_Genki
まとめ	summary; review	Bonus_Vocabulary Genki lesson-1 Words_in_Genki
とし	age; years	Bonus_Vocabulary Genki lesson-1 Words_in_Genki
しんぶん	newspaper	Genki lesson-2 Things Vocabulary
いくら	how much	Genki lesson-2 Money_and_Expressions Vocabulary
じゃあ	then...; if that is the case,...	Genki lesson-2 Money_and_Expressions Vocabulary
どうぞ	Please.; Here it is.	Genki lesson-2 Money_and_Expressions Vocabulary
どうも	Thank you.	Genki lesson-2 Money_and_Expressions Vocabulary
ていしょく	set meal; special (of the day)	Bonus_Vocabulary Food Genki lesson-2
こくばん	blackboard	Classroom_Objects Genki lesson-2 Useful_Expressions
いす	chair; stool	Classroom_Objects Genki lesson-2 Useful_Expressions
けしゴム	eraser	Classroom_Objects Genki lesson-2 Useful_Expressions
ゆっくりいってください。	Please say it slowly.	Genki In_the_Classroom lesson-2 Useful_Expressions
もういちどいってください。	Please say it again.	Genki In_the_Classroom lesson-2 Useful_Expressions
ちょっとまってください。	Please wait.	Genki In_the_Classroom lesson-2 Useful_Expressions
きいてください。	Please listen./Please ask.	Genki In_the_Classroom lesson-2 Useful_Expressions
<ruby>雑誌<rt>ざっし</rt></ruby>	magazine	Entertainment_and_Sports Genki lesson-3 Vocabulary
<ruby>お茶<rt>おちゃ</rt></ruby>	green tea	Food_and_Drinks Genki lesson-3 Vocabulary
～ごろ	at about...	Genki lesson-3 Places_and_Time Vocabulary
<ruby>寝る<rt>ねる</rt></ruby>	to sleep; to go to sleep	Genki lesson-3 Ru-verbs_and_Irregular_verbs Vocabulary
あまり	not much	Adverbs Genki lesson-3 Vocabulary
<ruby>全然<rt>ぜんぜん</rt></ruby>	not at all	Adverbs Genki lesson-3 Vocabulary
たいてい	usually	Adverbs Genki lesson-3 Vocabulary
ちょっと	a little	Adverbs Genki lesson-3 Vocabulary
よく	often; much	Adverbs Genki lesson-3 Vocabulary
そうですね	"That's right.; Let me see."	Adjectives_and_Expressions Genki lesson-3 Vocabulary
どうですか	How about...?; How is...?	Adjectives_and_Expressions Genki lesson-3 Vocabulary
<ruby>円<rt>えん</rt></ruby>	circle	Genki Kanji_Practice lesson-3 円_and_時
<ruby>円い<rt>まるい</rt></ruby>	round	Genki Kanji_Practice lesson-3 円_and_時
<ruby>お土産<rt>おみやげ</rt></ruby>	souvenir	Genki lesson-4 People_and_Things Vocabulary
<ruby>母の日<rt>ははのひ</rt></ruby>	"Mother's day"	Genki Kanji_Practice lesson-4 日_and_本
アルバイト	part-time job	Activities_and_Places Genki lesson-4 Vocabulary
<ruby>買い物<rt>かいもの</rt></ruby>	shopping	Activities_and_Places Genki lesson-4 Vocabulary
<ruby>公園<rt>こうえん</rt></ruby>	park	Activities_and_Places Genki lesson-4 Vocabulary
<ruby>バス停<rt>バスてい</rt></ruby>	bus stop	Activities_and_Places Genki lesson-4 Vocabulary
<ruby>一か月<rt>いっかげつ</rt></ruby>	one month	Genki Kanji_Practice lesson-4 人_and_月
<ruby>火<rt>ひ</rt></ruby>	fire	Genki Kanji_Practice lesson-4 火_and_水
<ruby>火山<rt>かざん</rt></ruby>	volcano	Genki Kanji_Practice lesson-4 火_and_水
<ruby>火星<rt>かせい</rt></ruby>	Mars	Genki Kanji_Practice lesson-4 火_and_水
<ruby>水泳<rt>すいえい</rt></ruby>	swimming	Genki Kanji_Practice lesson-4 火_and_水
<ruby>水着<rt>みずぎ</rt></ruby>	bathing suit	Genki Kanji_Practice lesson-4 火_and_水
<ruby>会う<rt>あう</rt></ruby>	to meet; to see (a person)	Genki lesson-4 U-verbs_and_Ru-verbs Vocabulary
<ruby>撮る<rt>とる</rt></ruby>	to take (a picture)	Genki lesson-4 U-verbs_and_Ru-verbs Vocabulary
<ruby>待つ<rt>まつ</rt></ruby>	to wait	Genki lesson-4 U-verbs_and_Ru-verbs Vocabulary
わかる	to understand	Genki lesson-4 U-verbs_and_Ru-verbs Vocabulary
<ruby>木村さん<rt>きむらさん</rt></ruby>	Mr./Ms. Kimura	Genki Kanji_Practice lesson-4 木,_金,_and_土
<ruby>料金<rt>りょうきん</rt></ruby>	charge	Genki Kanji_Practice lesson-4 木,_金,_and_土
<ruby>お金持ち<rt>おかねもち</rt></ruby>	rich person	Genki Kanji_Practice lesson-4 木,_金,_and_土
<ruby>土<rt>つち</rt></ruby>	soil	Genki Kanji_Practice lesson-4 木,_金,_and_土
<ruby>土地<rt>とち</rt></ruby>	land	Genki Kanji_Practice lesson-4 木,_金,_and_土
<ruby>粘土<rt>ねんど</rt></ruby>	clay	Genki Kanji_Practice lesson-4 木,_金,_and_土
～ぐらい	about (approximate measurement)	Adverbs_and_Expressions Genki lesson-4 Vocabulary
どうして	why	Adverbs_and_Expressions Genki lesson-4 Vocabulary
<ruby>屋上<rt>おくじょう</rt></ruby>	rooftop	Genki Kanji_Practice lesson-4 曜,_上,_and_下
<ruby>下手な<rt>へたな</rt></ruby>	poor at	Genki Kanji_Practice lesson-4 曜,_上,_and_下
<ruby>前<rt>まえ</rt></ruby>	front	Genki lesson-4 Location_Words Vocabulary
<ruby>後ろ<rt>うしろ</rt></ruby>	back	Genki lesson-4 Location_Words Vocabulary
<ruby>隣<rt>となり</rt></ruby>	next	Genki lesson-4 Location_Words Vocabulary
<ruby>間<rt>あいだ</rt></ruby>	between	Genki lesson-4 Location_Words Vocabulary
<ruby>一年中<rt>いちねんじゅう</rt></ruby>	all year round	Genki Kanji_Practice lesson-4 中_and_半
<ruby>半年<rt>はんとし</rt></ruby>	half a year	Genki Kanji_Practice lesson-4 中_and_半
<ruby>半額<rt>はんがく</rt></ruby>	half price	Genki Kanji_Practice lesson-4 中_and_半
ついたち	first day of the month	Days_1-15 Genki lesson-4 Useful_Expressions
ふつか	second day of the month	Days_1-15 Genki lesson-4 Useful_Expressions
みっか	third day of the month	Days_1-15 Genki lesson-4 Useful_Expressions
よっか	fourth day of the month	Days_1-15 Genki lesson-4 Useful_Expressions
いつか	fifth day of the month	Days_1-15 Genki lesson-4 Useful_Expressions
むいか	sixth day of the month	Days_1-15 Genki lesson-4 Useful_Expressions
なのか	seventh day of the month	Days_1-15 Genki lesson-4 Useful_Expressions
ようか	eighth day of the month	Days_1-15 Genki lesson-4 Useful_Expressions
ここのか	ninth day of the month	Days_1-15 Genki lesson-4 Useful_Expressions
とおか	tenth day of the month	Days_1-15 Genki lesson-4 Useful_Expressions
じゅういちにち	eleventh day of the month	Days_1-15 Genki lesson-4 Useful_Expressions
じゅうににち	twelfth day of the month	Days_1-15 Genki lesson-4 Useful_Expressions
じゅうさんにち	thirteenth day of the month	Days_1-15 Genki lesson-4 Useful_Expressions
じゅうよっか	fourteenth day of the month	Days_1-15 Genki lesson-4 Useful_Expressions
じゅうごにち	fifteenth day of the month	Days_1-15 Genki lesson-4 Useful_Expressions
じゅうろくにち	sixteenth day of the month	Days_16-31 Genki lesson-4 Useful_Expressions
じゅうしちにち	seventeenth day of the month	Days_16-31 Genki lesson-4 Useful_Expressions
じゅうはちにち	eighteenth day of the month	Days_16-31 Genki lesson-4 Useful_Expressions
じゅうくにち	nineteenth day of the month	Days_16-31 Genki lesson-4 Useful_Expressions
はつか	twentieth day of the month	Days_16-31 Genki lesson-4 Useful_Expressions
にじゅういちにち	twenty-first day of the month	Days_16-31 Genki lesson-4 Useful_Expressions
にじゅうににち	twenty-second day of the month	Days_16-31 Genki lesson-4 Useful_Expressions
にじゅうよっか	twenty-fourth day of the month	Days_16-31 Genki lesson-4 Useful_Expressions
にじゅうしちにち	twenty-seventh day of the month	Days_16-31 Genki lesson-4 Useful_Expressions
にじゅうはちにち	twenty-eighth day of the month	Days_16-31 Genki lesson-4 Useful_Expressions
にじゅうくにち	twenty-ninth day of the month	Days_16-31 Genki lesson-4 Useful_Expressions
おととい	the day before yesterday	Genki lesson-4 Time_Words Useful_Expressions
あさって	the day after tomorrow	Genki lesson-4 Time_Words Useful_Expressions
<ruby>二週間前<rt>にしゅうかんまえ</rt></ruby>	two weeks ago	Genki lesson-4 Time_Words Useful_Expressions
<ruby>二か月前<rt>にかげつまえ</rt></ruby>	two months ago	Genki lesson-4 Time_Words Useful_Expressions
おととし	the year before last	Genki lesson-4 Time_Words Useful_Expressions
<ruby>誕生日<rt>たんじょうび</rt></ruby>	birthday	Genki lesson-5 Nouns Vocabulary
<ruby>葉書<rt>はがき</rt></ruby>	postcard	Genki lesson-5 Nouns Vocabulary
<ruby>飛行機<rt>ひこうき</rt></ruby>	airplane	Genki lesson-5 Nouns Vocabulary
<ruby>部屋<rt>へや</rt></ruby>	room	Genki lesson-5 Nouns Vocabulary
<ruby>川<rt>かわ</rt></ruby>	river	Genki Kanji_Practice lesson-5 山,_川,_and_元
<ruby>元気な<rt>げんきな</rt></ruby>	fine	Genki Kanji_Practice lesson-5 山,_川,_and_元
<ruby>元日<rt>がんじつ</rt></ruby>	the first day of the year	Genki Kanji_Practice lesson-5 山,_川,_and_元
<ruby>地元<rt>じもと</rt></ruby>	local	Genki Kanji_Practice lesson-5 山,_川,_and_元
<ruby>忙しい<rt>いそがしい</rt></ruby>	busy (people/days)	Genki lesson-5 Vocabulary い-adjectives
かっこいい	good-looking	Genki lesson-5 Vocabulary い-adjectives
<ruby>怖い<rt>こわい</rt></ruby>	frightening	Genki lesson-5 Vocabulary い-adjectives
<ruby>楽しい<rt>たのしい</rt></ruby>	fun	Genki lesson-5 Vocabulary い-adjectives
つまらない	boring	Genki lesson-5 Vocabulary い-adjectives
<ruby>古い<rt>ふるい</rt></ruby>	old (thing)	Genki lesson-5 Vocabulary い-adjectives
やさしい	easy (problem); kind (person)	Genki lesson-5 Vocabulary い-adjectives
<ruby>安い<rt>やすい</rt></ruby>	inexpensive; cheap (thing)	Genki lesson-5 Vocabulary い-adjectives
<ruby>気持ち<rt>きもち</rt></ruby>	feeling	Genki Kanji_Practice lesson-5 気,_天,_and_私
<ruby>人気<rt>にんき</rt></ruby>	popularity	Genki Kanji_Practice lesson-5 気,_天,_and_私
<ruby>天国<rt>てんごく</rt></ruby>	heaven	Genki Kanji_Practice lesson-5 気,_天,_and_私
<ruby>天皇<rt>てんのう</rt></ruby>	Japanese emperor	Genki Kanji_Practice lesson-5 気,_天,_and_私
<ruby>私鉄<rt>してつ</rt></ruby>	private railroad	Genki Kanji_Practice lesson-5 気,_天,_and_私
<ruby>嫌い<rt>きらい（な）</rt></ruby>	disgusted with; to dislike	Genki lesson-5 Vocabulary な-adjectives
きれい（な）	beautiful; clean	Genki lesson-5 Vocabulary な-adjectives
<ruby>静か<rt>しずか（な）</rt></ruby>	quiet	Genki lesson-5 Vocabulary な-adjectives
<ruby>好き<rt>すき（な）</rt></ruby>	fond of; to like	Genki lesson-5 Vocabulary な-adjectives
<ruby>大嫌い<rt>だいきらい（な）</rt></ruby>	to hate	Genki lesson-5 Vocabulary な-adjectives
<ruby>大好き<rt>だいすき（な）</rt></ruby>	very fond of; to love	Genki lesson-5 Vocabulary な-adjectives
にぎやか（な）	lively	Genki lesson-5 Vocabulary な-adjectives
<ruby>暇<rt>ひま（な）</rt></ruby>	not busy; to have a lot of free time	Genki lesson-5 Vocabulary な-adjectives
<ruby>今<rt>いま</rt></ruby>	now	Genki Kanji_Practice lesson-5 今_and_田
<ruby>田んぼ<rt>たんぼ</rt></ruby>	rice field	Genki Kanji_Practice lesson-5 今_and_田
<ruby>聞く<rt>きく</rt></ruby>	to ask	Genki lesson-5 Verbs_and_Expressions Vocabulary
<ruby>乗る<rt>のる</rt></ruby>	to ride; to board	Genki lesson-5 Verbs_and_Expressions Vocabulary
やる	to do; to perform	Genki lesson-5 Verbs_and_Expressions Vocabulary
<ruby>一緒に<rt>いっしょに</rt></ruby>	together	Genki lesson-5 Verbs_and_Expressions Vocabulary
すごく	extremely	Genki lesson-5 Verbs_and_Expressions Vocabulary
それから	and then	Genki lesson-5 Verbs_and_Expressions Vocabulary
どんな	what kind of...	Genki lesson-5 Verbs_and_Expressions Vocabulary
<ruby>～枚<rt>～まい</rt></ruby>	[counter for flat objects]	Genki lesson-5 Verbs_and_Expressions Vocabulary
～まで	to (a place); as far as (a place); till (a time)	Genki lesson-5 Verbs_and_Expressions Vocabulary
<ruby>女の人<rt>おんなのひと</rt></ruby>	woman (kun-yomi)	Genki Kanji_Practice lesson-5 女_and_男
<ruby>女性<rt>じょせい</rt></ruby>	woman (on-yomi)	Genki Kanji_Practice lesson-5 女_and_男
<ruby>女の子<rt>おんなのこ</rt></ruby>	girl	Genki Kanji_Practice lesson-5 女_and_男
<ruby>長女<rt>ちょうじょ</rt></ruby>	the eldest daughter	Genki Kanji_Practice lesson-5 女_and_男
<ruby>男の人<rt>おとこのひと</rt></ruby>	man (kun-yomi)	Genki Kanji_Practice lesson-5 女_and_男
<ruby>男性<rt>だんせい</rt></ruby>	man (on-yomi)	Genki Kanji_Practice lesson-5 女_and_男
<ruby>男の子<rt>おとこのこ</rt></ruby>	boy	Genki Kanji_Practice lesson-5 女_and_男
<ruby>男子学生<rt>だんしがくせい</rt></ruby>	male student	Genki Kanji_Practice lesson-5 女_and_男
<ruby>窓口<rt>まどぐち</rt></ruby>	counter	Genki lesson-5 Post_Office_Words Useful_Expressions
はがき	postcard	Genki lesson-5 Post_Office_Words Useful_Expressions
<ruby>小包<rt>こづつみ</rt></ruby>	parcel	Genki lesson-5 Post_Office_Words Useful_Expressions
<ruby>航空便<rt>こうくうびん</rt></ruby>	airmail	Genki lesson-5 Post_Office_Words Useful_Expressions
<ruby>船便<rt>ふなびん</rt></ruby>	surface mail	Genki lesson-5 Post_Office_Words Useful_Expressions
<ruby>速達<rt>そくたつ</rt></ruby>	special delivery	Genki lesson-5 Post_Office_Words Useful_Expressions
<ruby>書留<rt>かきとめ</rt></ruby>	registered mail	Genki lesson-5 Post_Office_Words Useful_Expressions
<ruby>保険<rt>ほけん</rt></ruby>	insurance	Genki lesson-5 Post_Office_Words Useful_Expressions
<ruby>見物<rt>けんぶつ</rt></ruby>	sightseeing	Genki Kanji_Practice lesson-5 見_and_行
<ruby>意見<rt>いけん</rt></ruby>	opinion	Genki Kanji_Practice lesson-5 見_and_行
<ruby>一行目<rt>いちぎょうめ</rt></ruby>	first line	Genki Kanji_Practice lesson-5 見_and_行
五十円切手を三枚ください。	Give me three 50-yen stamps, please.	At_the_Post_Office Genki lesson-5 Useful_Expressions
(航空便)でお願いします。	Make this (an airmail), please.	At_the_Post_Office Genki lesson-5 Useful_Expressions
何日ぐらいかかりますか。	How many days will it take?	At_the_Post_Office Genki lesson-5 Useful_Expressions
百五十円になります。	It will be 150 yen.	At_the_Post_Office Genki lesson-5 Useful_Expressions
<ruby>食堂<rt>しょくどう</rt></ruby>	cafeteria	Genki Kanji_Practice lesson-5 食_and_飲
<ruby>朝食<rt>ちょうしょく</rt></ruby>	breakfast	Genki Kanji_Practice lesson-5 食_and_飲
<ruby>飲酒運転<rt>いんしゅうんてん</rt></ruby>	drunken driving	Genki Kanji_Practice lesson-5 食_and_飲
<ruby>教科書<rt>きょうかしょ</rt></ruby>	textbook	Genki lesson-6 Nouns Vocabulary
<ruby>市民病院<rt>しみんびょういん</rt></ruby>	municipal hospital	Genki lesson-6 Nouns Vocabulary
<ruby>東洋<rt>とうよう</rt></ruby>	the East	Genki Kanji_Practice lesson-6 東_and_西
<ruby>西<rt>にし</rt></ruby>	west	Genki Kanji_Practice lesson-6 東_and_西
<ruby>西口<rt>にしぐち</rt></ruby>	west exit	Genki Kanji_Practice lesson-6 東_and_西
<ruby>北西<rt>ほくせい</rt></ruby>	northwest	Genki Kanji_Practice lesson-6 東_and_西
<ruby>西洋<rt>せいよう</rt></ruby>	the West	Genki Kanji_Practice lesson-6 東_and_西
<ruby>大変<rt>たいへん（な）</rt></ruby>	tough (situation)	Genki lesson-6 Vocabulary な-adjective_and_U-verbs
<ruby>遊ぶ<rt>あそぶ</rt></ruby>	to play; to spend time pleasantly	Genki lesson-6 Vocabulary な-adjective_and_U-verbs
<ruby>急ぐ<rt>いそぐ</rt></ruby>	to hurry	Genki lesson-6 Vocabulary な-adjective_and_U-verbs
<ruby>返す<rt>かえす</rt></ruby>	to return (a thing)	Genki lesson-6 Vocabulary な-adjective_and_U-verbs
<ruby>消す<rt>けす</rt></ruby>	to turn off; to erase	Genki lesson-6 Vocabulary な-adjective_and_U-verbs
<ruby>座る<rt>すわる</rt></ruby>	to sit down	Genki lesson-6 Vocabulary な-adjective_and_U-verbs
<ruby>立つ<rt>たつ</rt></ruby>	to stand up	Genki lesson-6 Vocabulary な-adjective_and_U-verbs
<ruby>たばこを吸う<rt>たばこをすう</rt></ruby>	to smoke	Genki lesson-6 Vocabulary な-adjective_and_U-verbs
<ruby>手伝う<rt>てつだう</rt></ruby>	to help	Genki lesson-6 Vocabulary な-adjective_and_U-verbs
<ruby>持つ<rt>もつ</rt></ruby>	to carry; to hold	Genki lesson-6 Vocabulary な-adjective_and_U-verbs
<ruby>休む<rt>やすむ</rt></ruby>	to be absent (from...); to rest	Genki lesson-6 Vocabulary な-adjective_and_U-verbs
<ruby>南東<rt>なんとう</rt></ruby>	southeast	Genki Kanji_Practice lesson-6 南_and_北
<ruby>南極<rt>なんきょく</rt></ruby>	Antarctica	Genki Kanji_Practice lesson-6 南_and_北
<ruby>東南アジア<rt>とうなんアジア</rt></ruby>	Southeast Asia	Genki Kanji_Practice lesson-6 南_and_北
<ruby>北<rt>きた</rt></ruby>	north	Genki Kanji_Practice lesson-6 南_and_北
<ruby>北口<rt>きたぐち</rt></ruby>	north exit	Genki Kanji_Practice lesson-6 南_and_北
<ruby>東北<rt>とうほく</rt></ruby>	Tohoku area	Genki Kanji_Practice lesson-6 南_and_北
<ruby>北極<rt>ほっきょく</rt></ruby>	North Pole	Genki Kanji_Practice lesson-6 南_and_北
<ruby>開ける<rt>あける</rt></ruby>	to open (something)	Genki lesson-6 Ru-verbs_and_Irregular_verbs Vocabulary
<ruby>降りる<rt>おりる</rt></ruby>	to get off	Genki lesson-6 Ru-verbs_and_Irregular_verbs Vocabulary
<ruby>借りる<rt>かりる</rt></ruby>	to borrow	Genki lesson-6 Ru-verbs_and_Irregular_verbs Vocabulary
<ruby>閉める<rt>しめる</rt></ruby>	to close (something)	Genki lesson-6 Ru-verbs_and_Irregular_verbs Vocabulary
つける	to turn on	Genki lesson-6 Ru-verbs_and_Irregular_verbs Vocabulary
<ruby>電話をかける<rt>でんわをかける</rt></ruby>	to make a phone call	Genki lesson-6 Ru-verbs_and_Irregular_verbs Vocabulary
<ruby>忘れる<rt>わすれる</rt></ruby>	to forget; to leave behind	Genki lesson-6 Ru-verbs_and_Irregular_verbs Vocabulary
<ruby>連れてくる<rt>つれてくる</rt></ruby>	to bring (a person)	Genki lesson-6 Ru-verbs_and_Irregular_verbs Vocabulary
<ruby>持ってくる<rt>もってくる</rt></ruby>	to bring (a thing)	Genki lesson-6 Ru-verbs_and_Irregular_verbs Vocabulary
<ruby>人口<rt>じんこう</rt></ruby>	population	Genki Kanji_Practice lesson-6 口_and_出
<ruby>出口<rt>でぐち</rt></ruby>	exit	Genki Kanji_Practice lesson-6 口_and_出
<ruby>出席<rt>しゅっせき</rt></ruby>	attendance	Genki Kanji_Practice lesson-6 口_and_出
<ruby>輸出<rt>ゆしゅつ</rt></ruby>	export	Genki Kanji_Practice lesson-6 口_and_出
<ruby>後で<rt>あとで</rt></ruby>	later on	Adverbs_and_Other_Expressions Genki lesson-6 Vocabulary
<ruby>遅く<rt>おそく</rt></ruby>	(do something) late	Adverbs_and_Other_Expressions Genki lesson-6 Vocabulary
<ruby>結構です<rt>けっこうです</rt></ruby>	"That would be fine.; That wouldn't be necessary."	Adverbs_and_Other_Expressions Genki lesson-6 Vocabulary
すぐ	right away	Adverbs_and_Other_Expressions Genki lesson-6 Vocabulary
<ruby>右折<rt>うせつ</rt></ruby>	right turn	Genki Kanji_Practice lesson-6 右_and_左
<ruby>左右<rt>さゆう</rt></ruby>	right and left	Genki Kanji_Practice lesson-6 右_and_左
<ruby>右手<rt>みぎて</rt></ruby>	right hand	Genki Kanji_Practice lesson-6 右_and_左
<ruby>右側<rt>みぎがわ</rt></ruby>	right side	Genki Kanji_Practice lesson-6 右_and_左
<ruby>左折<rt>させつ</rt></ruby>	left turn	Genki Kanji_Practice lesson-6 右_and_左
<ruby>左手<rt>ひだりて</rt></ruby>	left hand	Genki Kanji_Practice lesson-6 右_and_左
<ruby>左利き<rt>ひだりきき</rt></ruby>	left-handed	Genki Kanji_Practice lesson-6 右_and_左
<ruby>まっすぐ行く<rt>まっすぐいき</rt></ruby>	go straight	Directions Genki lesson-6 Useful_Expressions
<ruby>左に曲がる<rt>ひだりにまがる</rt></ruby>	turn left	Directions Genki lesson-6 Useful_Expressions
<ruby>右に曲がる<rt>みぎにまがる</rt></ruby>	turn right	Directions Genki lesson-6 Useful_Expressions
<ruby>道を渡る<rt>みちをわたる</rt></ruby>	cross the street	Directions Genki lesson-6 Useful_Expressions
<ruby>二つ目の角を左に曲がる<rt>ふたつめのかどをひだりにまがる</rt></ruby>	turn left at the second corner	Directions Genki lesson-6 Useful_Expressions
<ruby>一つ目の信号を右に曲がる<rt>ひとつめのしんごうをみぎにまがる</rt></ruby>	turn right at the first traffic light	Directions Genki lesson-6 Useful_Expressions
<ruby>道の左側<rt>みちのひだりがわ</rt></ruby>	left side of the street	Directions Genki lesson-6 Useful_Expressions
<ruby>道の右側<rt>みちのみぎがわ</rt></ruby>	right side of the street	Directions Genki lesson-6 Useful_Expressions
<ruby>十分<rt>じゅっぷん／じっぷん</rt></ruby>	ten minutes	Genki Kanji_Practice lesson-6 分,_先,_and_生
<ruby>分ける<rt>わける</rt></ruby>	to divide	Genki Kanji_Practice lesson-6 分,_先,_and_生
<ruby>先に<rt>さきに</rt></ruby>	ahead	Genki Kanji_Practice lesson-6 分,_先,_and_生
<ruby>先輩<rt>せんぱい</rt></ruby>	senior member	Genki Kanji_Practice lesson-6 分,_先,_and_生
<ruby>一生に一度<rt>いっしょうにいちど</rt></ruby>	once in a life time	Genki Kanji_Practice lesson-6 分,_先,_and_生
<ruby>大使館<rt>たいしかん</rt></ruby>	embassy	Genki Kanji_Practice lesson-6 大_and_学
<ruby>学部<rt>がくぶ</rt></ruby>	department; faculty	Genki Kanji_Practice lesson-6 大_and_学
<ruby>外国<rt>がいこく</rt></ruby>	foreign country	Genki Kanji_Practice lesson-6 外_and_国
<ruby>国<rt>くに</rt></ruby>	country	Genki Kanji_Practice lesson-6 外_and_国
<ruby>国会<rt>こっかい</rt></ruby>	the Diet	Genki Kanji_Practice lesson-6 外_and_国
<ruby>歌<rt>うた</rt></ruby>	song	Genki lesson-7 Nouns_1 Vocabulary
<ruby>女の人<rt>おんなのひと</rt></ruby>	woman	Genki lesson-7 Nouns_1 Vocabulary
<ruby>電子辞書<rt>でんしじしょ</rt></ruby>	electronic dictionary	Genki Kanji_Practice lesson-7 京,_子,_and_小
<ruby>小学校<rt>しょうがっこう</rt></ruby>	elementary school	Genki Kanji_Practice lesson-7 京,_子,_and_小
<ruby>小学生<rt>しょうがくせい</rt></ruby>	elementary school student	Genki Kanji_Practice lesson-7 京,_子,_and_小
サークル	club activity	Genki lesson-7 Nouns_2 Vocabulary
<ruby>眼鏡<rt>めがね</rt></ruby>	glasses	Genki lesson-7 Nouns_2 Vocabulary
<ruby>会う<rt>あう</rt></ruby>	to meet	Genki Kanji_Practice lesson-7 会_and_社
<ruby>教会<rt>きょうかい</rt></ruby>	church	Genki Kanji_Practice lesson-7 会_and_社
<ruby>神社<rt>じんじゃ</rt></ruby>	shrine	Genki Kanji_Practice lesson-7 会_and_社
<ruby>社会<rt>しゃかい</rt></ruby>	society	Genki Kanji_Practice lesson-7 会_and_社
<ruby>頭がいい<rt>あたまがいい</rt></ruby>	bright; smart; clever	Genki lesson-7 Vocabulary い-adjectives_and_な-adjectives
<ruby>背が高い<rt>せがたかい</rt></ruby>	tall (stature)	Genki lesson-7 Vocabulary い-adjectives_and_な-adjectives
<ruby>背が低い<rt>せがひくい</rt></ruby>	short (stature)	Genki lesson-7 Vocabulary い-adjectives_and_な-adjectives
<ruby>長い<rt>ながい</rt></ruby>	long	Genki lesson-7 Vocabulary い-adjectives_and_な-adjectives
<ruby>速い<rt>はやい</rt></ruby>	fast	Genki lesson-7 Vocabulary い-adjectives_and_な-adjectives
<ruby>短い<rt>みじかい</rt></ruby>	short (length)	Genki lesson-7 Vocabulary い-adjectives_and_な-adjectives
<ruby>便利<rt>べんり(な)</rt></ruby>	convenient	Genki lesson-7 Vocabulary い-adjectives_and_な-adjectives
<ruby>父母<rt>ふぼ</rt></ruby>	father and mother	Genki Kanji_Practice lesson-7 父_and_母
<ruby>祖父<rt>そふ</rt></ruby>	grandfather	Genki Kanji_Practice lesson-7 父_and_母
<ruby>母語<rt>ぼご</rt></ruby>	mother tongue	Genki Kanji_Practice lesson-7 父_and_母
<ruby>祖母<rt>そぼ</rt></ruby>	grandmother	Genki Kanji_Practice lesson-7 父_and_母
<ruby>歌う<rt>うたう</rt></ruby>	to sing	Genki lesson-7 U-verbs,_Ru-verbs,_and_Irregular_Verbs Vocabulary
かぶる	to put on (a hat)	Genki lesson-7 U-verbs,_Ru-verbs,_and_Irregular_Verbs Vocabulary
<ruby>知る<rt>しる</rt></ruby>	to get to know	Genki lesson-7 U-verbs,_Ru-verbs,_and_Irregular_Verbs Vocabulary
<ruby>知っています<rt>しっています</rt></ruby>	I know	Genki lesson-7 U-verbs,_Ru-verbs,_and_Irregular_Verbs Vocabulary
<ruby>知りません<rt>しりません</rt></ruby>	I do not know	Genki lesson-7 U-verbs,_Ru-verbs,_and_Irregular_Verbs Vocabulary
はく	to put on (items below your waist)	Genki lesson-7 U-verbs,_Ru-verbs,_and_Irregular_Verbs Vocabulary
(めがねを)かける	to put on (glasses)	Genki lesson-7 U-verbs,_Ru-verbs,_and_Irregular_Verbs Vocabulary
<ruby>着る<rt>きる</rt></ruby>	to put on (clothes above your waist)	Genki lesson-7 U-verbs,_Ru-verbs,_and_Irregular_Verbs Vocabulary
<ruby>勤める<rt>つとめる</rt></ruby>	to work for	Genki lesson-7 U-verbs,_Ru-verbs,_and_Irregular_Verbs Vocabulary
やせる	to lose weight	Genki lesson-7 U-verbs,_Ru-verbs,_and_Irregular_Verbs Vocabulary
やせています	to be thin	Genki lesson-7 U-verbs,_Ru-verbs,_and_Irregular_Verbs Vocabulary
<ruby>最高<rt>さいこう</rt></ruby>	the best	Genki Kanji_Practice lesson-7 高,_校,_and_毎
<ruby>中学校<rt>ちゅうがっこう</rt></ruby>	junior high school	Genki Kanji_Practice lesson-7 高,_校,_and_毎
<ruby>何も<rt>なにも</rt></ruby>	not...anything	Adverbs_and_Other_Expressions Genki lesson-7 Vocabulary
<ruby>別に<rt>べつに</rt></ruby>	nothing in particular	Adverbs_and_Other_Expressions Genki lesson-7 Vocabulary
もちろん	of course	Adverbs_and_Other_Expressions Genki lesson-7 Vocabulary
よかったら	if you like	Adverbs_and_Other_Expressions Genki lesson-7 Vocabulary
<ruby>文字<rt>もじ</rt></ruby>	letter; character	Genki Kanji_Practice lesson-7 語_and_文
<ruby>文法<rt>ぶんぽう</rt></ruby>	grammar	Genki Kanji_Practice lesson-7 語_and_文
<ruby>指<rt>ゆび</rt></ruby>	finger	Genki lesson-7 Parts_of_the_Body Useful_Expressions
<ruby>鼻<rt>はな</rt></ruby>	nose	Genki lesson-7 Parts_of_the_Body Useful_Expressions
<ruby>顔<rt>かお</rt></ruby>	face	Genki lesson-7 Parts_of_the_Body Useful_Expressions
<ruby>頭<rt>あたま</rt></ruby>	head	Genki lesson-7 Parts_of_the_Body Useful_Expressions
<ruby>肩<rt>かた</rt></ruby>	shoulder	Genki lesson-7 Parts_of_the_Body Useful_Expressions
<ruby>胸<rt>むね</rt></ruby>	chest	Genki lesson-7 Parts_of_the_Body Useful_Expressions
<ruby>背中<rt>せなか</rt></ruby>	back (of body)	Genki lesson-7 Parts_of_the_Body Useful_Expressions
おなか	belly; stomach	Genki lesson-7 Parts_of_the_Body Useful_Expressions
おしり	bottom; buttocks	Genki lesson-7 Parts_of_the_Body Useful_Expressions
<ruby>帰る<rt>かえる</rt></ruby>	to return	Genki Kanji_Practice lesson-7 帰_and_入
<ruby>帰国<rt>きこく</rt></ruby>	"returning to one's country"	Genki Kanji_Practice lesson-7 帰_and_入
<ruby>帰宅<rt>きたく</rt></ruby>	returning home	Genki Kanji_Practice lesson-7 帰_and_入
<ruby>帰り<rt>かえり</rt></ruby>	return	Genki Kanji_Practice lesson-7 帰_and_入
ruby>輸入<rt>ゆにゅう</rt></ruby>	import	Genki Kanji_Practice lesson-7 帰_and_入
<ruby>七人<rt>しちにん／ななにん</rt></ruby>	seven people	Bonus_Vocabulary Counting_People Genki lesson-7
<ruby>空気<rt>くうき</rt></ruby>	air	Genki lesson-8 Nouns_1 Vocabulary
<ruby>黒板<rt>こくばん</rt></ruby>	blackboard	Genki lesson-8 Nouns_1 Vocabulary
<ruby>店員<rt>てんいん</rt></ruby>	store clerk	Genki Kanji_Practice lesson-8 員,_新,_and_聞
<ruby>会員<rt>かいいん</rt></ruby>	member	Genki Kanji_Practice lesson-8 員,_新,_and_聞
<ruby>新幹線<rt>しんかんせん</rt></ruby>	Bullet Train	Genki Kanji_Practice lesson-8 員,_新,_and_聞
<ruby>新鮮な<rt>しんせんな</rt></ruby>	fresh	Genki Kanji_Practice lesson-8 員,_新,_and_聞
<ruby>聞く<rt>きく</rt></ruby>	to listen	Genki Kanji_Practice lesson-8 員,_新,_and_聞
<ruby>聞こえる<rt>きこえる</rt></ruby>	can be heard	Genki Kanji_Practice lesson-8 員,_新,_and_聞
<ruby>冬<rt>ふゆ</rt></ruby>	winter	Genki lesson-8 Nouns_2 Vocabulary
<ruby>作る<rt>つくる</rt></ruby>	to make	Genki Kanji_Practice lesson-8 作,_仕,_and_事
<ruby>作品<rt>さくひん</rt></ruby>	artistic piece	Genki Kanji_Practice lesson-8 作,_仕,_and_事
<ruby>仕返し<rt>しかえし</rt></ruby>	revenge	Genki Kanji_Practice lesson-8 作,_仕,_and_事
<ruby>仕える<rt>つかえる</rt></ruby>	to serve; to work under	Genki Kanji_Practice lesson-8 作,_仕,_and_事
<ruby>火事<rt>かじ</rt></ruby>	fire (disaster)	Genki Kanji_Practice lesson-8 作,_仕,_and_事
<ruby>返事<rt>へんじ</rt></ruby>	reply	Genki Kanji_Practice lesson-8 作,_仕,_and_事
<ruby>上手<rt>じょうず(な)</rt></ruby>	skillful; good at	Genki lesson-8 Vocabulary な-adjectives_and_U-verbs
<ruby>下手<rt>へた(な)</rt></ruby>	clumsy; poor at	Genki lesson-8 Vocabulary な-adjectives_and_U-verbs
<ruby>有名<rt>ゆうめい(な)</rt></ruby>	famous	Genki lesson-8 Vocabulary な-adjectives_and_U-verbs
<ruby>洗う<rt>あらう</rt></ruby>	to wash	Genki lesson-8 Vocabulary な-adjectives_and_U-verbs
<ruby>遅くなる<rt>おそくなる</rt></ruby>	to be late	Genki lesson-8 Vocabulary な-adjectives_and_U-verbs
<ruby>思う<rt>おもう</rt></ruby>	to think	Genki lesson-8 Vocabulary な-adjectives_and_U-verbs
<ruby>持っていく<rt>もっていく</rt></ruby>	to take (a thing)	Genki lesson-8 Vocabulary な-adjectives_and_U-verbs
<ruby>車いす<rt>くるまいす</rt></ruby>	wheel chair	Genki Kanji_Practice lesson-8 電_and_車
<ruby>駐車場<rt>ちゅうしゃじょう</rt></ruby>	parking lot	Genki Kanji_Practice lesson-8 電_and_車
<ruby>じろじろ見る<rt>じろじろみる</rt></ruby>	to stare (at...)	Genki lesson-8 Ru-verbs_and_Irregular_verbs Vocabulary
<ruby>捨てる<rt>すてる</rt></ruby>	to throw away	Genki lesson-8 Ru-verbs_and_Irregular_verbs Vocabulary
<ruby>始める<rt>はじめる</rt></ruby>	to begin	Genki lesson-8 Ru-verbs_and_Irregular_verbs Vocabulary
<ruby>掃除する<rt>そうじする</rt></ruby>	to clean	Genki lesson-8 Ru-verbs_and_Irregular_verbs Vocabulary
<ruby>料理する<rt>りょうりする</rt></ruby>	to cook	Genki lesson-8 Ru-verbs_and_Irregular_verbs Vocabulary
<ruby>言語学<rt>げんごがく</rt></ruby>	linguistics	Genki Kanji_Practice lesson-8 休,_言,_and_読
<ruby>言葉<rt>ことば</rt></ruby>	word; language	Genki Kanji_Practice lesson-8 休,_言,_and_読
<ruby>読み物<rt>よみもの</rt></ruby>	reading matter; reading material	Genki Kanji_Practice lesson-8 休,_言,_and_読
ううん	uh-uh; no	Adverbs_and_Other_Expressions Genki lesson-8 Vocabulary
うん	uh-huh; yes	Adverbs_and_Other_Expressions Genki lesson-8 Vocabulary
<ruby>残念(ですね)<rt>ざんねん(ですね)</rt></ruby>	"That's too bad."	Adverbs_and_Other_Expressions Genki lesson-8 Vocabulary
～について	about...; concerning...	Adverbs_and_Other_Expressions Genki lesson-8 Vocabulary
まだ+negative	not...yet	Adverbs_and_Other_Expressions Genki lesson-8 Vocabulary
<ruby>不思議な<rt>ふしぎな</rt></ruby>	mysterious	Genki Kanji_Practice lesson-8 思,_次,_and_何
<ruby>思い出す<rt>おもいだす</rt></ruby>	to recall; to remember	Genki Kanji_Practice lesson-8 思,_次,_and_何
<ruby>次女<rt>じじょ</rt></ruby>	second daughter	Genki Kanji_Practice lesson-8 思,_次,_and_何
<ruby>ご飯<rt>ごはん</rt></ruby>	Rice	Common_Dishes_in_Japan Culture_Note Genki lesson-8
おかず	side dish	Common_Dishes_in_Japan Culture_Note Genki lesson-8
<ruby>定食<rt>ていしょく</rt></ruby>	set meal	Common_Dishes_in_Japan Culture_Note Genki lesson-8
<ruby>焼き魚<rt>やきざかな</rt></ruby>	Broiled fish	Common_Dishes_in_Japan Culture_Note Genki lesson-8
<ruby>いい子<rt>いいこ</rt></ruby>	good child	Genki lesson-9 Nouns Vocabulary
<ruby>薬<rt>くすり</rt></ruby>	medicine	Genki lesson-9 Nouns Vocabulary
<ruby>薬を飲む<rt>くすりをのむ</rt></ruby>	to take medicine	Genki lesson-9 Nouns Vocabulary
<ruby>今度<rt>こんど</rt></ruby>	near future	Genki lesson-9 Nouns Vocabulary
<ruby>作文<rt>さくぶん</rt></ruby>	essay; composition	Genki lesson-9 Nouns Vocabulary
<ruby>単語<rt>たんご</rt></ruby>	word; vocabulary	Genki lesson-9 Nouns Vocabulary
<ruby>病気<rt>びょうき</rt></ruby>	illness; sickness	Genki lesson-9 Nouns Vocabulary
<ruby>午前中<rt>ごぜんちゅう</rt></ruby>	in the morning	Genki Kanji_Practice lesson-9 午,_後,_and_前
<ruby>正午<rt>しょうご</rt></ruby>	noon	Genki Kanji_Practice lesson-9 午,_後,_and_前
<ruby>～の後<rt>～のあと</rt></ruby>	after...	Genki Kanji_Practice lesson-9 午,_後,_and_前
<ruby>最後に<rt>さいごに</rt></ruby>	lastly	Genki Kanji_Practice lesson-9 午,_後,_and_前
<ruby>前<rt>まえ</rt></ruby>	before; front	Genki Kanji_Practice lesson-9 午,_後,_and_前
<ruby>前売り<rt>まえうり</rt></ruby>	advance sale	Genki Kanji_Practice lesson-9 午,_後,_and_前
<ruby>寂しい<rt>さびしい</rt></ruby>	lonely	Genki lesson-9 Vocabulary い-adjectives_and_な-adjectives
<ruby>白い<rt>しろい</rt></ruby>	white	Genki lesson-9 Vocabulary い-adjectives_and_な-adjectives
<ruby>若い<rt>わかい</rt></ruby>	young	Genki lesson-9 Vocabulary い-adjectives_and_な-adjectives
<ruby>意地悪<rt>いじわる(な)</rt></ruby>	mean-spirited	Genki lesson-9 Vocabulary い-adjectives_and_な-adjectives
<ruby>有名な<rt>ゆうめいな</rt></ruby>	famous	Genki Kanji_Practice lesson-9 名_and_白
<ruby>名刺<rt>めいし</rt></ruby>	name card	Genki Kanji_Practice lesson-9 名_and_白
<ruby>地名<rt>ちめい</rt></ruby>	place name	Genki Kanji_Practice lesson-9 名_and_白
<ruby>白紙<rt>はくし</rt></ruby>	blank sheet	Genki Kanji_Practice lesson-9 名_and_白
<ruby>白鳥<rt>はくちょう</rt></ruby>	swan	Genki Kanji_Practice lesson-9 名_and_白
<ruby>踊る<rt>おどる</rt></ruby>	to dance	Genki lesson-9 U-verbs,_Ru-verbs,_and_Irregular_Verbs Vocabulary
<ruby>終わる<rt>おわる</rt></ruby>	(something) ends	Genki lesson-9 U-verbs,_Ru-verbs,_and_Irregular_Verbs Vocabulary
<ruby>弾く<rt>ひく</rt></ruby>	to play (a string instrument or piano)	Genki lesson-9 U-verbs,_Ru-verbs,_and_Irregular_Verbs Vocabulary
もらう	to get (from somebody)	Genki lesson-9 U-verbs,_Ru-verbs,_and_Irregular_Verbs Vocabulary
<ruby>覚える<rt>おぼえる</rt></ruby>	to memorize	Genki lesson-9 U-verbs,_Ru-verbs,_and_Irregular_Verbs Vocabulary
<ruby>運動する<rt>うんどうする</rt></ruby>	to do physical exercises	Genki lesson-9 U-verbs,_Ru-verbs,_and_Irregular_Verbs Vocabulary
<ruby>散歩する<rt>さんぽする</rt></ruby>	to take a walk	Genki lesson-9 U-verbs,_Ru-verbs,_and_Irregular_Verbs Vocabulary
<ruby>雨期<rt>うき</rt></ruby>	rainy season	Genki Kanji_Practice lesson-9 雨,_書,_and_友
<ruby>梅雨<rt>つゆ</rt></ruby>	rainy season (East Asia)	Genki Kanji_Practice lesson-9 雨,_書,_and_友
<ruby>親友<rt>しんゆう</rt></ruby>	best friend	Genki Kanji_Practice lesson-9 雨,_書,_and_友
<ruby>友人<rt>ゆうじん</rt></ruby>	friend (formal)	Genki Kanji_Practice lesson-9 雨,_書,_and_友
<ruby>友情<rt>ゆうじょう</rt></ruby>	friendship	Genki Kanji_Practice lesson-9 雨,_書,_and_友
<ruby>是非<rt>ぜひ</rt></ruby>	by all means	Adverbs_and_Other_Expressions Genki lesson-9 Vocabulary
ところで	by the way	Adverbs_and_Other_Expressions Genki lesson-9 Vocabulary
もう	already	Adverbs_and_Other_Expressions Genki lesson-9 Vocabulary
<ruby>一週間<rt>いっしゅうかん</rt></ruby>	one week	Genki Kanji_Practice lesson-9 間_and_家
<ruby>家内<rt>かない</rt></ruby>	my wife	Genki Kanji_Practice lesson-9 間_and_家
<ruby>話<rt>はなし</rt></ruby>	talk; story	Genki Kanji_Practice lesson-9 話_and_少
<ruby>少ない<rt>すくない</rt></ruby>	few	Genki Kanji_Practice lesson-9 話_and_少
<ruby>少々<rt>しょうしょう</rt></ruby>	a little	Genki Kanji_Practice lesson-9 話_and_少
<ruby>紫<rt>むらさき</rt></ruby>	purple	Color_Names Genki lesson-9 Useful_Expressions
<ruby>金色／ゴールド<rt>きんいろ／---</rt></ruby>	gold	Color_Names Genki lesson-9 Useful_Expressions
<ruby>銀色／シルバー<rt>ぎんいろ／---</rt></ruby>	silver	Color_Names Genki lesson-9 Useful_Expressions
<ruby>古代<rt>こだい</rt></ruby>	ancient times	Genki Kanji_Practice lesson-9 古,_知,_and_来
<ruby>知人<rt>ちじん</rt></ruby>	acquaintance (formal)	Genki Kanji_Practice lesson-9 古,_知,_and_来
<ruby>知り合い<rt>しりあい</rt></ruby>	acquaintance	Genki Kanji_Practice lesson-9 古,_知,_and_来
<ruby>来日<rt>らいにち</rt></ruby>	visit to Japan	Genki Kanji_Practice lesson-9 古,_知,_and_来
<ruby>黒猫<rt>くろねこ</rt></ruby>	black cat	Colors Genki lesson-9 Useful_Expressions
<ruby>顔が青いですね。<rt>かおがあおいですね。</rt></ruby>	Your face looks pale.	Colors Genki lesson-9 Useful_Expressions
<ruby>白黒の写真<rt>しろくろのしゃしん</rt></ruby>	black and white picture	Colors Genki lesson-9 Useful_Expressions
<ruby>メアリーさんは金髪です。<rt>メアリーさんはきんぱつです。</rt></ruby>	Mary has blonde hair.	Colors Genki lesson-9 Useful_Expressions
いろいろおせわになりました。	Thank you for everything.	Genki lesson-9 Letters Useful_Expressions
体に気をつけてください。	Please take care of yourself.	Genki lesson-9 Letters Useful_Expressions
お会いできるのを楽しみにしています。	I am looking forward to seeing you.	Genki lesson-9 Letters Useful_Expressions
～おめでとう（ございます）。	Congratulations on...	Genki lesson-9 Letters Useful_Expressions
（お）たんじょうびおめでとう。	Happy birthday.	Genki lesson-9 Letters Useful_Expressions
<ruby>季節<rt>きせつ</rt></ruby>	season	Genki lesson-10 Nouns_1 Vocabulary
<ruby>移住する<rt>いじゅうする</rt></ruby>	to immigrate	Genki Kanji_Practice lesson-10 住,_正,_and_年
<ruby>お正月<rt>おしょうがつ</rt></ruby>	New Year	Genki Kanji_Practice lesson-10 住,_正,_and_年
<ruby>床屋<rt>とこや</rt></ruby>	"barber's"	Genki lesson-10 Nouns_2 Vocabulary
<ruby>春<rt>はる</rt></ruby>	spring	Genki lesson-10 Nouns_2 Vocabulary
<ruby>美容院<rt>びよういん</rt></ruby>	beauty parlor	Genki lesson-10 Nouns_2 Vocabulary
<ruby>便<rt>びん</rt></ruby>	flight	Genki lesson-10 Nouns_2 Vocabulary
<ruby>船<rt>ふね</rt></ruby>	ship; boat	Genki lesson-10 Nouns_2 Vocabulary
<ruby>有名人<rt>ゆうめいじん</rt></ruby>	celebrity	Genki lesson-10 Nouns_2 Vocabulary
<ruby>予約<rt>よやく</rt></ruby>	reservation	Genki lesson-10 Nouns_2 Vocabulary
<ruby>来学期<rt>らいがっき</rt></ruby>	next semester	Genki lesson-10 Nouns_2 Vocabulary
<ruby>売店<rt>ばいてん</rt></ruby>	stand; stall	Genki Kanji_Practice lesson-10 売,_買,_and_町
<ruby>自動販売機<rt>じどうはんばいき</rt></ruby>	vending machine	Genki Kanji_Practice lesson-10 売,_買,_and_町
<ruby>売買<rt>ばいばい</rt></ruby>	selling and buying	Genki Kanji_Practice lesson-10 売,_買,_and_町
<ruby>町長<rt>ちょうちょう</rt></ruby>	mayor of a town	Genki Kanji_Practice lesson-10 売,_買,_and_町
<ruby>暖かい<rt>あたたかい</rt></ruby>	warm	Genki lesson-10 Vocabulary い-adjectives_and_な-adjectives
<ruby>涼しい<rt>すずしい</rt></ruby>	cold (weather)	Genki lesson-10 Vocabulary い-adjectives_and_な-adjectives
<ruby>冷たい<rt>つめたい</rt></ruby>	cold (things/people)	Genki lesson-10 Vocabulary い-adjectives_and_な-adjectives
<ruby>眠い<rt>ねむい</rt></ruby>	sleepy	Genki lesson-10 Vocabulary い-adjectives_and_な-adjectives
<ruby>簡単<rt>かんたん（な）</rt></ruby>	easy; simple	Genki lesson-10 Vocabulary い-adjectives_and_な-adjectives
<ruby>長男<rt>ちょうなん</rt></ruby>	the eldest son	Genki Kanji_Practice lesson-10 長,_道,_and_雪
<ruby>書道<rt>しょどう</rt></ruby>	calligraphy	Genki Kanji_Practice lesson-10 長,_道,_and_雪
<ruby>新雪<rt>しんせつ</rt></ruby>	new snow	Genki Kanji_Practice lesson-10 長,_道,_and_雪
<ruby>雪だるま<rt>ゆきだるま</rt></ruby>	snowman	Genki Kanji_Practice lesson-10 長,_道,_and_雪
かかる	to take (amount of time/money)	Genki lesson-10 U-verbs,_Ru-verbs,_and_Irregular_Verbs Vocabulary
<ruby>泊まる<rt>とまる</rt></ruby>	to stay (at a hotel, etc)	Genki lesson-10 U-verbs,_Ru-verbs,_and_Irregular_Verbs Vocabulary
<ruby>旅行する<rt>りょこうする</rt></ruby>	to travel	Genki lesson-10 U-verbs,_Ru-verbs,_and_Irregular_Verbs Vocabulary
<ruby>国立大学<rt>こくりつだいがく</rt></ruby>	national university	Genki Kanji_Practice lesson-10 立,_自,_and_夜
<ruby>私立高校<rt>しりつこうこう</rt></ruby>	private high school	Genki Kanji_Practice lesson-10 立,_自,_and_夜
<ruby>自動車<rt>じどうしゃ</rt></ruby>	automobile	Genki Kanji_Practice lesson-10 立,_自,_and_夜
<ruby>夜中<rt>よなか</rt></ruby>	midnight	Genki Kanji_Practice lesson-10 立,_自,_and_夜
<ruby>夜明け<rt>よあけ</rt></ruby>	dawn	Genki Kanji_Practice lesson-10 立,_自,_and_夜
<ruby>歩いて<rt>あるいて</rt></ruby>	on foot	Adverbs_and_Other_Expressions Genki lesson-10 Vocabulary
<ruby>一番<rt>いちばん</rt></ruby>	best	Adverbs_and_Other_Expressions Genki lesson-10 Vocabulary
～か～	or	Adverbs_and_Other_Expressions Genki lesson-10 Vocabulary
このごろ	these days	Adverbs_and_Other_Expressions Genki lesson-10 Vocabulary
<ruby>～週間<rt>～しゅうかん</rt></ruby>	for...weeks	Adverbs_and_Other_Expressions Genki lesson-10 Vocabulary
～で	by (means of transportation); with (a tool)	Adverbs_and_Other_Expressions Genki lesson-10 Vocabulary
どうやって	how; by what means	Adverbs_and_Other_Expressions Genki lesson-10 Vocabulary
どちら／どっち	which	Adverbs_and_Other_Expressions Genki lesson-10 Vocabulary
どのぐらい	how much; how long	Adverbs_and_Other_Expressions Genki lesson-10 Vocabulary
<ruby>所持品<rt>しょじひん</rt></ruby>	belongings	Genki Kanji_Practice lesson-10 朝_and_持
<ruby>普通<rt>ふつう</rt></ruby>	local train	At_the_Station_1 Genki lesson-10 Useful_Expressions
<ruby>急行<rt>きゅうこう</rt></ruby>	express train	At_the_Station_1 Genki lesson-10 Useful_Expressions
<ruby>特急<rt>とっきゅう</rt></ruby>	super express train	At_the_Station_1 Genki lesson-10 Useful_Expressions
<ruby>～行き<rt>～いき</rt></ruby>	bound for...	At_the_Station_1 Genki lesson-10 Useful_Expressions
<ruby>～方面<rt>～ほうめん</rt></ruby>	serving...areas	At_the_Station_1 Genki lesson-10 Useful_Expressions
<ruby>乗車券<rt>じょうしゃけん</rt></ruby>	(boarding) ticket	At_the_Station_1 Genki lesson-10 Useful_Expressions
<ruby>回数券<rt>かいすうけん</rt></ruby>	coupons	At_the_Station_1 Genki lesson-10 Useful_Expressions
<ruby>定期券<rt>ていきけん</rt></ruby>	"commuter's pass"	At_the_Station_1 Genki lesson-10 Useful_Expressions
<ruby>学割<rt>がくわり</rt></ruby>	student discount	At_the_Station_1 Genki lesson-10 Useful_Expressions
<ruby>指定席<rt>していせき</rt></ruby>	reserved seat	At_the_Station_1 Genki lesson-10 Useful_Expressions
<ruby>自由席<rt>じゆうせき</rt></ruby>	general admission seat	At_the_Station_1 Genki lesson-10 Useful_Expressions
<ruby>禁煙車<rt>きんえんしゃ</rt></ruby>	non-smoking car	At_the_Station_1 Genki lesson-10 Useful_Expressions
<ruby>一号車<rt>いちごうしゃ</rt></ruby>	Car No.1	At_the_Station_1 Genki lesson-10 Useful_Expressions
<ruby>往復<rt>おうふく</rt></ruby>	round trip	At_the_Station_1 Genki lesson-10 Useful_Expressions
<ruby>片道<rt>かたみち</rt></ruby>	one way	At_the_Station_1 Genki lesson-10 Useful_Expressions
<ruby>～番線<rt>～ばんせん</rt></ruby>	track number...	At_the_Station_2 Genki lesson-10 Useful_Expressions
<ruby>切符売り場<rt>きっぷうりば</rt></ruby>	ticket vending area	At_the_Station_2 Genki lesson-10 Useful_Expressions
<ruby>改札<rt>かいさつ</rt></ruby>	gate	At_the_Station_2 Genki lesson-10 Useful_Expressions
ホーム	platform	At_the_Station_2 Genki lesson-10 Useful_Expressions
<ruby>売店<rt>ばいてん</rt></ruby>	shop; stand	At_the_Station_2 Genki lesson-10 Useful_Expressions
<ruby>階段<rt>かいだん</rt></ruby>	stairs	At_the_Station_2 Genki lesson-10 Useful_Expressions
<ruby>いちばん前<rt>いちばんまえ</rt></ruby>	first car; front end	At_the_Station_2 Genki lesson-10 Useful_Expressions
<ruby>いちばん後ろ<rt>いちばんうしろ</rt></ruby>	last car; tail end	At_the_Station_2 Genki lesson-10 Useful_Expressions
<ruby>乗り換え<rt>のりかえ</rt></ruby>	transfer	At_the_Station_2 Genki lesson-10 Useful_Expressions
<ruby>先発<rt>せんぱつ</rt></ruby>	departing first	At_the_Station_2 Genki lesson-10 Useful_Expressions
<ruby>次発<rt>じはつ</rt></ruby>	departing second	At_the_Station_2 Genki lesson-10 Useful_Expressions
<ruby>終電<rt>しゅうでん</rt></ruby>	last train	At_the_Station_2 Genki lesson-10 Useful_Expressions
<ruby>まもなく発車します。<rt>まもなくはっしゃします。</rt></ruby>	We will be leaving soon.	At_the_Station_3 Genki lesson-10 Useful_Expressions
<ruby>電車が参ります。<rt>でんしゃがまいります。</rt></ruby>	A train is arriving.	At_the_Station_3 Genki lesson-10 Useful_Expressions
<ruby>次は～に止まります。<rt>つぎは～にとまります。</rt></ruby>	"Next (we'll stop at)..."	At_the_Station_3 Genki lesson-10 Useful_Expressions
<ruby>ドアが閉まります。ご注意ください。<rt>ドアがしまります。ごちゅういください。</rt></ruby>	The doors are closing. Please be careful.	At_the_Station_3 Genki lesson-10 Useful_Expressions
<ruby>この電車は秋葉原に止まりますか。<rt>このでんしゃはあきはばらにとまりますか。</rt></ruby>	Does this train stop at Akihabara?	At_the_Station_3 Genki lesson-10 Useful_Expressions
<ruby>終電は何時ですか。<rt>しゅうでんはなんじですか。</rt></ruby>	What time is the last train.	At_the_Station_3 Genki lesson-10 Useful_Expressions
<ruby>東京までの指定席を一枚お願いします。<rt>とうきょうまでのしていせきをいちまいおねがいします。</rt></ruby>	One reserved ticket to Tokyo, please.	At_the_Station_3 Genki lesson-10 Useful_Expressions
<ruby>学割が使えますか。<rt>がくわりがつかえますか。</rt></ruby>	Can I get a student discount?	At_the_Station_3 Genki lesson-10 Useful_Expressions
<ruby>お祭り<rt>おまつり</rt></ruby>	festival	Genki lesson-11 Nouns_1 Vocabulary
<ruby>温泉<rt>おんせん</rt></ruby>	spa; hot spring	Genki lesson-11 Nouns_1 Vocabulary
<ruby>歌手<rt>かしゅ</rt></ruby>	singer	Genki lesson-11 Nouns_1 Vocabulary
<ruby>手話<rt>しゅわ</rt></ruby>	sign language	Genki Kanji_Practice lesson-11 手,_紙,_and_好
<ruby>紙<rt>かみ</rt></ruby>	paper	Genki Kanji_Practice lesson-11 手,_紙,_and_好
<ruby>和紙<rt>わし</rt></ruby>	Japanese paper	Genki Kanji_Practice lesson-11 手,_紙,_and_好
<ruby>表紙<rt>ひょうし</rt></ruby>	front cover	Genki Kanji_Practice lesson-11 手,_紙,_and_好
<ruby>好意<rt>こうい</rt></ruby>	good will	Genki Kanji_Practice lesson-11 手,_紙,_and_好
<ruby>好み<rt>このみ</rt></ruby>	liking; taste	Genki Kanji_Practice lesson-11 手,_紙,_and_好
<ruby>好物<rt>こうぶつ</rt></ruby>	favorite food	Genki Kanji_Practice lesson-11 手,_紙,_and_好
<ruby>今学期<rt>こんがっき</rt></ruby>	this semester	Genki lesson-11 Nouns_2 Vocabulary
<ruby>授業<rt>じゅぎょう</rt></ruby>	class	Genki lesson-11 Nouns_2 Vocabulary
<ruby>将来<rt>しょうらい</rt></ruby>	future	Genki lesson-11 Nouns_2 Vocabulary
つり	fishing	Genki lesson-11 Nouns_2 Vocabulary
<ruby>最近<rt>さいきん</rt></ruby>	recently	Genki Kanji_Practice lesson-11 近,_明,_病,_and_院
<ruby>説明<rt>せつめい</rt></ruby>	explanation	Genki Kanji_Practice lesson-11 近,_明,_病,_and_院
<ruby>発明<rt>はつめい</rt></ruby>	invention	Genki Kanji_Practice lesson-11 近,_明,_病,_and_院
<ruby>文明<rt>ぶんめい</rt></ruby>	civilization	Genki Kanji_Practice lesson-11 近,_明,_病,_and_院
<ruby>重病<rt>じゅうびょう</rt></ruby>	serious illness	Genki Kanji_Practice lesson-11 近,_明,_病,_and_院
<ruby>急病<rt>きゅうびょう</rt></ruby>	sudden illness	Genki Kanji_Practice lesson-11 近,_明,_病,_and_院
うそをつく	to tell a lie	Genki lesson-11 U-verbs,_Ru-verbs,_and_Irregular_Verbs Vocabulary
おなかがすく	to become hungry	Genki lesson-11 U-verbs,_Ru-verbs,_and_Irregular_Verbs Vocabulary
<ruby>飼う<rt>かう</rt></ruby>	to own (a pet)	Genki lesson-11 U-verbs,_Ru-verbs,_and_Irregular_Verbs Vocabulary
サボる	to cut (classes)	Genki lesson-11 U-verbs,_Ru-verbs,_and_Irregular_Verbs Vocabulary
<ruby>取る<rt>とる</rt></ruby>	to take (a class); to get (a grade)	Genki lesson-11 U-verbs,_Ru-verbs,_and_Irregular_Verbs Vocabulary
<ruby>疲れる<rt>つかれる</rt></ruby>	to get tired	Genki lesson-11 U-verbs,_Ru-verbs,_and_Irregular_Verbs Vocabulary
けんかする	to have a fight; to quarrel	Genki lesson-11 U-verbs,_Ru-verbs,_and_Irregular_Verbs Vocabulary
<ruby>紹介する<rt>しょうかいする</rt></ruby>	to introduce	Genki lesson-11 U-verbs,_Ru-verbs,_and_Irregular_Verbs Vocabulary
<ruby>遅刻する<rt>ちこくする</rt></ruby>	to be late (for an appointment)	Genki lesson-11 U-verbs,_Ru-verbs,_and_Irregular_Verbs Vocabulary
<ruby>留学する<rt>りゅうがくする</rt></ruby>	to study abroad	Genki lesson-11 U-verbs,_Ru-verbs,_and_Irregular_Verbs Vocabulary
<ruby>映る<rt>うつる</rt></ruby>	to be reflected	Genki Kanji_Practice lesson-11 映,_画,_and_歌
<ruby>画家<rt>がか</rt></ruby>	painter	Genki Kanji_Practice lesson-11 映,_画,_and_歌
<ruby>計画<rt>けいかく</rt></ruby>	plan	Genki Kanji_Practice lesson-11 映,_画,_and_歌
<ruby>漫画<rt>まんが</rt></ruby>	comic	Genki Kanji_Practice lesson-11 映,_画,_and_歌
<ruby>国歌<rt>こっか</rt></ruby>	national anthem	Genki Kanji_Practice lesson-11 映,_画,_and_歌
<ruby>歌詞<rt>かし</rt></ruby>	lyrics	Genki Kanji_Practice lesson-11 映,_画,_and_歌
そして	and then	Adverbs_and_Other_Expressions Genki lesson-11 Vocabulary
～だけ	just...; only...	Adverbs_and_Other_Expressions Genki lesson-11 Vocabulary
<ruby>久しぶり<rt>ひさしぶり</rt></ruby>	it has been a long time	Adverbs_and_Other_Expressions Genki lesson-11 Vocabulary
まあまあ	okay; so-so	Adverbs_and_Other_Expressions Genki lesson-11 Vocabulary
もっと	more	Adverbs_and_Other_Expressions Genki lesson-11 Vocabulary
<ruby>市役所<rt>しやくしょ</rt></ruby>	city hall	Genki Kanji_Practice lesson-11 市,_所,_and_勉
<ruby>市長<rt>しちょう</rt></ruby>	mayor	Genki Kanji_Practice lesson-11 市,_所,_and_勉
<ruby>市場<rt>いちば</rt></ruby>	market	Genki Kanji_Practice lesson-11 市,_所,_and_勉
<ruby>いろいろな所<rt>いろいろなところ</rt></ruby>	various places	Genki Kanji_Practice lesson-11 市,_所,_and_勉
<ruby>勉める<rt>つとめる</rt></ruby>	to try hard	Genki Kanji_Practice lesson-11 市,_所,_and_勉
<ruby>勤勉な<rt>きんべんな</rt></ruby>	diligent	Genki Kanji_Practice lesson-11 市,_所,_and_勉
<ruby>職業<rt>しょくぎょう</rt></ruby>	occupation; business	Genki lesson-11 Occupations Vocabulary
<ruby>作家<rt>さっか</rt></ruby>	writer	Genki lesson-11 Occupations Vocabulary
ジャーナリスト	journalist	Genki lesson-11 Occupations Vocabulary
<ruby>警察官<rt>けいさつかん</rt></ruby>	police officer	Genki lesson-11 Occupations Vocabulary
<ruby>俳優<rt>はいゆう</rt></ruby>	actor; actress	Genki lesson-11 Occupations Vocabulary
<ruby>女優<rt>じょゆう</rt></ruby>	actress	Genki lesson-11 Occupations Vocabulary
<ruby>看護師<rt>かんごし</rt></ruby>	nurse	Genki lesson-11 Occupations Vocabulary
<ruby>消防士<rt>しょうぼうし</rt></ruby>	firefighter	Genki lesson-11 Occupations Vocabulary
<ruby>漫画家<rt>まんがか</rt></ruby>	cartoonist	Genki lesson-11 Occupations Vocabulary
<ruby>宇宙飛行士<rt>うちゅうひこうし</rt></ruby>	astronaut	Genki lesson-11 Occupations Vocabulary
<ruby>野球選手<rt>やきゅうせんしゅ</rt></ruby>	baseball player	Genki lesson-11 Occupations Vocabulary
<ruby>大統領<rt>だいとうりょう</rt></ruby>	president of a country	Genki lesson-11 Occupations Vocabulary
<ruby>強情な<rt>ごうじょうな</rt></ruby>	obstinate	Genki Kanji_Practice lesson-11 強,_有,_and_旅
<ruby>強盗<rt>ごうとう</rt></ruby>	robbery	Genki Kanji_Practice lesson-11 強,_有,_and_旅
<ruby>強力な<rt>きょうりょくな</rt></ruby>	powerful	Genki Kanji_Practice lesson-11 強,_有,_and_旅
<ruby>有料<rt>ゆうりょう</rt></ruby>	toll; fee	Genki Kanji_Practice lesson-11 強,_有,_and_旅
<ruby>有能な<rt>ゆうのうな</rt></ruby>	talented	Genki Kanji_Practice lesson-11 強,_有,_and_旅
<ruby>一人旅<rt>ひとりたび</rt></ruby>	traveling alone	Genki Kanji_Practice lesson-11 強,_有,_and_旅
<ruby>旅券<rt>りょけん</rt></ruby>	passport	Genki Kanji_Practice lesson-11 強,_有,_and_旅
どちらでもいいです。	Both are fine.	Genki In_the_Japanese_Class lesson-11 Useful_Expressions
<ruby>同じです。<rt>おなじです。</rt></ruby>	Same thing.	Genki In_the_Japanese_Class lesson-11 Useful_Expressions
<ruby>だいたい同じです。<rt>だいたいおなじです。</rt></ruby>	More or less the same.	Genki In_the_Japanese_Class lesson-11 Useful_Expressions
<ruby>ちょっと違います。<rt>ちょっとちがいます。</rt></ruby>	A little different.	Genki In_the_Japanese_Class lesson-11 Useful_Expressions
<ruby>使えません。<rt>つかえません。</rt></ruby>	"Can't use it."	Genki In_the_Japanese_Class lesson-11 Useful_Expressions
<ruby>手をあげてください。<rt>てをあげてください。</rt></ruby>	Raise your hand.	Genki In_the_Japanese_Class lesson-11 Useful_Expressions
<ruby>読んできてください。<rt>よんできてください。</rt></ruby>	Read it before coming to class.	Genki In_the_Japanese_Class lesson-11 Useful_Expressions
<ruby>宿題を出してください。<rt>しゅくだいをだしてください。</rt></ruby>	Hand in the homework.	Genki In_the_Japanese_Class lesson-11 Useful_Expressions
<ruby>教科書を閉じてください。<rt>きょうかしょをとじてください。</rt></ruby>	Close the textbook.	Genki In_the_Japanese_Class lesson-11 Useful_Expressions
<ruby>となりの人に聞いてください。<rt>となりのひとにきいてください。</rt></ruby>	Ask the person sitting next to you.	Genki In_the_Japanese_Class lesson-11 Useful_Expressions
やめてください。	Please stop.	Genki In_the_Japanese_Class lesson-11 Useful_Expressions
<ruby>今日はこれで終わります。<rt>きょうはこれでおわります。</rt></ruby>	"That's it for today."	Genki In_the_Japanese_Class lesson-11 Useful_Expressions
しめきり	deadline	Genki Japanese_Class_Vocabulary_1 lesson-11 Useful_Expressions
<ruby>練習<rt>れんしゅう</rt></ruby>	practice; (an) exercise	Genki Japanese_Class_Vocabulary_1 lesson-11 Useful_Expressions
<ruby>質問<rt>しつもん</rt></ruby>	questions	Genki Japanese_Class_Vocabulary_1 lesson-11 Useful_Expressions
<ruby>答<rt>こたえ</rt></ruby>	answer	Genki Japanese_Class_Vocabulary_1 lesson-11 Useful_Expressions
<ruby>例<rt>れい</rt></ruby>	example	Genki Japanese_Class_Vocabulary_1 lesson-11 Useful_Expressions
かっこ	( ) (parenthesis)	Genki Japanese_Class_Vocabulary_1 lesson-11 Useful_Expressions
まる	〇 (correct)	Genki Japanese_Class_Vocabulary_1 lesson-11 Useful_Expressions
ばつ	✕ (wrong)	Genki Japanese_Class_Vocabulary_1 lesson-11 Useful_Expressions
<ruby>くだけた言い方<rt>くだけたいいかた</rt></ruby>	colloquial expression	Genki Japanese_Class_Vocabulary_2 lesson-11 Useful_Expressions
<ruby>かたい言い方<rt>かたいいいかた</rt></ruby>	bookish expression	Genki Japanese_Class_Vocabulary_2 lesson-11 Useful_Expressions
<ruby>ていねいな言い方<rt>ていねいないいかた</rt></ruby>	polite expression	Genki Japanese_Class_Vocabulary_2 lesson-11 Useful_Expressions
<ruby>標準語<rt>ひょうじゅんご</rt></ruby>	standard Japanese	Genki Japanese_Class_Vocabulary_2 lesson-11 Useful_Expressions
ほかに	anything else	Genki Japanese_Class_Vocabulary_2 lesson-11 Useful_Expressions
<ruby>～行目<rt>～ぎょうめ</rt></ruby>	line number	Genki Japanese_Class_Vocabulary_2 lesson-11 Useful_Expressions
<ruby>気温<rt>きおん</rt></ruby>	temperature (weather)	Genki lesson-12 Nouns_1 Vocabulary
<ruby>政治<rt>せいじ</rt></ruby>	politics	Genki lesson-12 Nouns_1 Vocabulary
<ruby>成績<rt>せいせき</rt></ruby>	grade (on a test, etc.)	Genki lesson-12 Nouns_1 Vocabulary
<ruby>昔<rt>むかし</rt></ruby>	old times	Genki Kanji_Practice lesson-12 昔,_々,_and_神
<ruby>昔話<rt>むかしばなし</rt></ruby>	old tale	Genki Kanji_Practice lesson-12 昔,_々,_and_神
<ruby>大昔<rt>おおむかし</rt></ruby>	ancient times	Genki Kanji_Practice lesson-12 昔,_々,_and_神
<ruby>昔々<rt>むかしむかし</rt></ruby>	once upon a time	Genki Kanji_Practice lesson-12 昔,_々,_and_神
<ruby>神さま<rt>かみさま</rt></ruby>	God	Genki Kanji_Practice lesson-12 昔,_々,_and_神
<ruby>神道<rt>しんとう</rt></ruby>	Shinto religion	Genki Kanji_Practice lesson-12 昔,_々,_and_神
<ruby>神戸市<rt>こうべし</rt></ruby>	Kobe City	Genki Kanji_Practice lesson-12 昔,_々,_and_神
せき	cough	Genki lesson-12 Nouns_2 Vocabulary
のど	throat	Genki lesson-12 Nouns_2 Vocabulary
<ruby>晴れ<rt>はれ</rt></ruby>	sunny weather	Genki lesson-12 Nouns_2 Vocabulary
<ruby>二日酔い<rt>ふつかよい</rt></ruby>	hangover	Genki lesson-12 Nouns_2 Vocabulary
<ruby>用事<rt>ようじ</rt></ruby>	business to take care of	Genki lesson-12 Nouns_2 Vocabulary
<ruby>早起きする<rt>はやおきする</rt></ruby>	to get up early	Genki Kanji_Practice lesson-12 早,_起,_and_牛
<ruby>早朝<rt>そうちょう</rt></ruby>	early morning	Genki Kanji_Practice lesson-12 早,_起,_and_牛
<ruby>起こす<rt>おこす</rt></ruby>	to wake someone up	Genki Kanji_Practice lesson-12 早,_起,_and_牛
<ruby>牛<rt>うし</rt></ruby>	cow	Genki Kanji_Practice lesson-12 早,_起,_and_牛
<ruby>牛肉<rt>ぎゅうにく</rt></ruby>	beef	Genki Kanji_Practice lesson-12 早,_起,_and_牛
<ruby>子牛<rt>こうし</rt></ruby>	calf; veal	Genki Kanji_Practice lesson-12 早,_起,_and_牛
<ruby>甘い<rt>あまい</rt></ruby>	sweet	Genki lesson-12 Vocabulary い-adjectives_and_な-adjectives
<ruby>痛い<rt>いたい</rt></ruby>	hurt; painful	Genki lesson-12 Vocabulary い-adjectives_and_な-adjectives
<ruby>多い<rt>おおい</rt></ruby>	there are many	Genki lesson-12 Vocabulary い-adjectives_and_な-adjectives
<ruby>都合が悪い<rt>つごうがわるい</rt></ruby>	inconvenient; to have a scheduling conflict	Genki lesson-12 Vocabulary い-adjectives_and_な-adjectives
<ruby>悪い<rt>わるい</rt></ruby>	bad	Genki lesson-12 Vocabulary い-adjectives_and_な-adjectives
<ruby>素敵<rt>すてき（な）</rt></ruby>	nice	Genki lesson-12 Vocabulary い-adjectives_and_な-adjectives
<ruby>大使<rt>たいし</rt></ruby>	ambassador	Genki Kanji_Practice lesson-12 使,_働,_and_連
<ruby>使用中<rt>しようちゅう</rt></ruby>	"""Occupied"""	Genki Kanji_Practice lesson-12 使,_働,_and_連
<ruby>お使い<rt>おつかい</rt></ruby>	errand	Genki Kanji_Practice lesson-12 使,_働,_and_連
<ruby>共働き<rt>ともばたらき</rt></ruby>	both husband and wife working	Genki Kanji_Practice lesson-12 使,_働,_and_連
<ruby>労働<rt>ろうどう</rt></ruby>	labor	Genki Kanji_Practice lesson-12 使,_働,_and_連
<ruby>連れて帰る<rt>つれてかえる</rt></ruby>	to bring (a person) back	Genki Kanji_Practice lesson-12 使,_働,_and_連
<ruby>国連<rt>こくれん</rt></ruby>	United Nations	Genki Kanji_Practice lesson-12 使,_働,_and_連
<ruby>連休<rt>れんきゅう</rt></ruby>	consecutive holidays	Genki Kanji_Practice lesson-12 使,_働,_and_連
<ruby>興味がある<rt>きょうみがある</rt></ruby>	to be interested (in...)	Genki lesson-12 U-verbs,_Ru-verbs,_and_Irregular_Verbs Vocabulary
なくす	to lose	Genki lesson-12 U-verbs,_Ru-verbs,_and_Irregular_Verbs Vocabulary
<ruby>熱がある<rt>ねつがある</rt></ruby>	to have a fever	Genki lesson-12 U-verbs,_Ru-verbs,_and_Irregular_Verbs Vocabulary
<ruby>のどが渇く<rt>のどがかわく</rt></ruby>	to become thirsty	Genki lesson-12 U-verbs,_Ru-verbs,_and_Irregular_Verbs Vocabulary
<ruby>せきが出る<rt>せきがでる</rt></ruby>	to cough	Genki lesson-12 U-verbs,_Ru-verbs,_and_Irregular_Verbs Vocabulary
<ruby>別れる<rt>わかれる</rt></ruby>	to break up; to separate	Genki lesson-12 U-verbs,_Ru-verbs,_and_Irregular_Verbs Vocabulary
<ruby>緊張する<rt>きんちょうする</rt></ruby>	to get nervous	Genki lesson-12 U-verbs,_Ru-verbs,_and_Irregular_Verbs Vocabulary
<ruby>心配する<rt>しんぱいする</rt></ruby>	to worry	Genki lesson-12 U-verbs,_Ru-verbs,_and_Irregular_Verbs Vocabulary
<ruby>別に<rt>べつに</rt></ruby>	not in particular	Genki Kanji_Practice lesson-12 別_and_度
<ruby>差別<rt>さべつ</rt></ruby>	discrimination	Genki Kanji_Practice lesson-12 別_and_度
<ruby>別々に<rt>べつべつに</rt></ruby>	separately	Genki Kanji_Practice lesson-12 別_and_度
<ruby>一度<rt>いちど</rt></ruby>	once	Genki Kanji_Practice lesson-12 別_and_度
<ruby>温度<rt>おんど</rt></ruby>	temperature	Genki Kanji_Practice lesson-12 別_and_度
<ruby>三十度<rt>さんじゅうど</rt></ruby>	30 degrees	Genki Kanji_Practice lesson-12 別_and_度
<ruby>お大事に<rt>おだいじに</rt></ruby>	Get well soon.	Adverbs_and_Other_Expressions Genki lesson-12 Vocabulary
<ruby>多分<rt>たぶん</rt></ruby>	probably; maybe	Adverbs_and_Other_Expressions Genki lesson-12 Vocabulary
できるだけ	as much as possible	Adverbs_and_Other_Expressions Genki lesson-12 Vocabulary
～でしょう	probably; ..., right?	Adverbs_and_Other_Expressions Genki lesson-12 Vocabulary
<ruby>二三日<rt>にさんにち</rt></ruby>	for two to three days	Adverbs_and_Other_Expressions Genki lesson-12 Vocabulary
～ので	because...	Adverbs_and_Other_Expressions Genki lesson-12 Vocabulary
<ruby>初めて<rt>はじめて</rt></ruby>	for the first time	Adverbs_and_Other_Expressions Genki lesson-12 Vocabulary
もうすぐ	very soon; in a few moments/days	Adverbs_and_Other_Expressions Genki lesson-12 Vocabulary
<ruby>赤道<rt>せきどう</rt></ruby>	the equator	Genki Kanji_Practice lesson-12 赤,_青,_and_色
<ruby>赤十字<rt>せきじゅうじ</rt></ruby>	the Red Cross	Genki Kanji_Practice lesson-12 赤,_青,_and_色
<ruby>青年<rt>せいねん</rt></ruby>	youth	Genki Kanji_Practice lesson-12 赤,_青,_and_色
<ruby>青信号<rt>あおしんごう</rt></ruby>	green light	Genki Kanji_Practice lesson-12 赤,_青,_and_色
<ruby>景色<rt>けしき</rt></ruby>	scenery	Genki Kanji_Practice lesson-12 赤,_青,_and_色
<ruby>特色<rt>とくしょく</rt></ruby>	characteristic	Genki Kanji_Practice lesson-12 赤,_青,_and_色
<ruby>下痢です。<rt>げりです。</rt></ruby>	I have diarrhea	Genki Health_and_Illness lesson-12 Useful_Expressions
<ruby>便秘です。<rt>べんぴです。</rt></ruby>	I am constipated.	Genki Health_and_Illness lesson-12 Useful_Expressions
<ruby>生理です。<rt>せいりです。</rt></ruby>	I have my period.	Genki Health_and_Illness lesson-12 Useful_Expressions
<ruby>花粉症です。<rt>かふんしょうです。</rt></ruby>	I have hay fever.	Genki Health_and_Illness lesson-12 Useful_Expressions
（～に）アレルギーがあります。	I have an allergy to...	Genki Health_and_Illness lesson-12 Useful_Expressions
<ruby>虫歯があります。<rt>むしばがあります。</rt></ruby>	I have a bad tooth.	Genki Health_and_Illness lesson-12 Useful_Expressions
<ruby>くしゃみが出ます。<rt>くしゃみがでます。</rt></ruby>	I sneeze.	Genki Health_and_Illness lesson-12 Useful_Expressions
<ruby>鼻水が出ます。<rt>はなみずがでます。</rt></ruby>	I have a runny nose.	Genki Health_and_Illness lesson-12 Useful_Expressions
<ruby>背中がかゆいです。<rt>せなかがかゆいです。</rt></ruby>	My back itches.	Genki Health_and_Illness lesson-12 Useful_Expressions
<ruby>発疹があります。<rt>はっしんがあります。</rt></ruby>	I have rashes.	Genki Health_and_Illness lesson-12 Useful_Expressions
めまいがします。	I feel dizzy.	Genki Health_and_Illness lesson-12 Useful_Expressions
<ruby>吐きました。<rt>はきました。</rt></ruby>	I threw up.	Genki Health_and_Illness lesson-12 Useful_Expressions
<ruby>気分が悪いです。<rt>きぶんがわるいです。</rt></ruby>	I am not feeling well.	Genki Health_and_Illness lesson-12 Useful_Expressions
やけどをしました。	I burned myself.	Genki Health_and_Illness lesson-12 Useful_Expressions
<ruby>足の骨を折りました。<rt>あしのほねをおりました。</rt></ruby>	I broke my leg.	Genki Health_and_Illness lesson-12 Useful_Expressions
けがをしました。	I hurt myself.	Genki Health_and_Illness lesson-12 Useful_Expressions
<ruby>皮膚科<rt>ひふか</rt></ruby>	dermatologist	Doctor's_Office_Words Genki lesson-12 Useful_Expressions
<ruby>外科<rt>げか</rt></ruby>	surgeon	Doctor's_Office_Words Genki lesson-12 Useful_Expressions
<ruby>産婦人科<rt>さんふじんか</rt></ruby>	obstetrician and gynecologist	Doctor's_Office_Words Genki lesson-12 Useful_Expressions
<ruby>整形外科<rt>せいけいげか</rt></ruby>	orthopedic surgeon	Doctor's_Office_Words Genki lesson-12 Useful_Expressions
<ruby>眼科／目医者<rt>がんか／めいしゃ</rt></ruby>	ophthalmologist	Doctor's_Office_Words Genki lesson-12 Useful_Expressions
<ruby>歯科／歯医者<rt>しか／はいしゃ</rt></ruby>	dentist	Doctor's_Office_Words Genki lesson-12 Useful_Expressions
<ruby>抗生物質<rt>こうせいぶっしつ</rt></ruby>	antibiotic	Doctor's_Office_Words Genki lesson-12 Useful_Expressions
レントゲン	X-ray	Doctor's_Office_Words Genki lesson-12 Useful_Expressions
<ruby>手術<rt>しゅじゅつ</rt></ruby>	operation	Doctor's_Office_Words Genki lesson-12 Useful_Expressions
<ruby>注射<rt>ちゅうしゃ</rt></ruby>	injection	Doctor's_Office_Words Genki lesson-12 Useful_Expressions
<ruby>体温計<rt>たいおんけい</rt></ruby>	thermometer	Doctor's_Office_Words Genki lesson-12 Useful_Expressions
<ruby>お宅<rt>おたく</rt></ruby>	"(someone's) house/home"	Genki lesson-13 Nouns_1 Vocabulary
<ruby>広告<rt>こうこく</rt></ruby>	advertisement	Genki lesson-13 Nouns_1 Vocabulary
<ruby>動物<rt>どうぶつ</rt></ruby>	animal	Genki Kanji_Practice lesson-13 物,_鳥,_and_料
<ruby>料理<rt>りょうり</rt></ruby>	cooking	Genki Kanji_Practice lesson-13 物,_鳥,_and_料
<ruby>授業料<rt>じゅぎょうりょう</rt></ruby>	tuition	Genki Kanji_Practice lesson-13 物,_鳥,_and_料
<ruby>給料<rt>きゅうりょう</rt></ruby>	salary	Genki Kanji_Practice lesson-13 物,_鳥,_and_料
<ruby>物価<rt>ぶっか</rt></ruby>	(consumer) prices	Genki lesson-13 Nouns_2 Vocabulary
<ruby>弁護士<rt>べんごし</rt></ruby>	lawyer	Genki lesson-13 Nouns_2 Vocabulary
<ruby>募集<rt>ぼしゅう</rt></ruby>	recruitment	Genki lesson-13 Nouns_2 Vocabulary
<ruby>店<rt>みせ</rt></ruby>	shop; store	Genki lesson-13 Nouns_2 Vocabulary
やくざ	yakuza; gangster	Genki lesson-13 Nouns_2 Vocabulary
<ruby>約束<rt>やくそく</rt></ruby>	promise; appointment	Genki lesson-13 Nouns_2 Vocabulary
レポート	(term) paper	Genki lesson-13 Nouns_2 Vocabulary
<ruby>理由<rt>りゆう</rt></ruby>	reason	Genki Kanji_Practice lesson-13 理,_特,_and_安
<ruby>無理な<rt>むりな</rt></ruby>	impossible	Genki Kanji_Practice lesson-13 理,_特,_and_安
<ruby>特に<rt>とくに</rt></ruby>	especially	Genki Kanji_Practice lesson-13 理,_特,_and_安
<ruby>特徴<rt>とくちょう</rt></ruby>	characteristic	Genki Kanji_Practice lesson-13 理,_特,_and_安
<ruby>特急<rt>とっきゅう</rt></ruby>	super express	Genki Kanji_Practice lesson-13 理,_特,_and_安
うれしい	glad	Genki lesson-13 Vocabulary い-adjectives_and_な-adjectives
<ruby>悲しい<rt>かなしい</rt></ruby>	sad	Genki lesson-13 Vocabulary い-adjectives_and_な-adjectives
<ruby>辛い<rt>からい</rt></ruby>	hot and spicy; salty	Genki lesson-13 Vocabulary い-adjectives_and_な-adjectives
<ruby>厳しい<rt>きびしい</rt></ruby>	strict	Genki lesson-13 Vocabulary い-adjectives_and_な-adjectives
<ruby>幸せ<rt>しあわせ（な）</rt></ruby>	happy (lasting happiness)	Genki lesson-13 Vocabulary い-adjectives_and_な-adjectives
だめ（な）	no good	Genki lesson-13 Vocabulary い-adjectives_and_な-adjectives
<ruby>肉<rt>にく</rt></ruby>	meat	Genki Kanji_Practice lesson-13 飯,_肉,_and_悪
<ruby>筋肉<rt>きんにく</rt></ruby>	muscle	Genki Kanji_Practice lesson-13 飯,_肉,_and_悪
<ruby>気分が悪い<rt>きぶんがわるい</rt></ruby>	to feel sick	Genki Kanji_Practice lesson-13 飯,_肉,_and_悪
<ruby>最悪<rt>さいあく</rt></ruby>	the worst	Genki Kanji_Practice lesson-13 飯,_肉,_and_悪
<ruby>悪魔<rt>あくま</rt></ruby>	devil	Genki Kanji_Practice lesson-13 飯,_肉,_and_悪
<ruby>編む<rt>あむ</rt></ruby>	to knit	Genki lesson-13 U-verbs_and_Irregular_Verbs Vocabulary
<ruby>貸す<rt>かす</rt></ruby>	to lend; to rent	Genki lesson-13 U-verbs_and_Irregular_Verbs Vocabulary
<ruby>泣く<rt>なく</rt></ruby>	to cry	Genki lesson-13 U-verbs_and_Irregular_Verbs Vocabulary
<ruby>約束を守る<rt>やくそくをまもる</rt></ruby>	to keep a promise	Genki lesson-13 U-verbs_and_Irregular_Verbs Vocabulary
<ruby>感動する<rt>かんどうする</rt></ruby>	to be moved/touched (by...)	Genki lesson-13 U-verbs_and_Irregular_Verbs Vocabulary
<ruby>体操<rt>たいそう</rt></ruby>	gymnastics; physical exercises	Genki Kanji_Practice lesson-13 体,_空,_and_港
<ruby>空く<rt>あく</rt></ruby>	to be vacant	Genki Kanji_Practice lesson-13 体,_空,_and_港
<ruby>神戸港<rt>こうべこう</rt></ruby>	Kobe Port	Genki Kanji_Practice lesson-13 体,_空,_and_港
いらっしゃいませ	someone honorable is present/home	Adverbs_and_Other_Expressions Genki lesson-13 Vocabulary
<ruby>～回<rt>～かい</rt></ruby>	...times	Adverbs_and_Other_Expressions Genki lesson-13 Vocabulary
<ruby>～と申します<rt>～ともうします</rt></ruby>	my name is...	Adverbs_and_Other_Expressions Genki lesson-13 Vocabulary
<ruby>着く<rt>つく</rt></ruby>	to arrive	Genki Kanji_Practice lesson-13 着,_同,_海,_and_昼
<ruby>大阪着<rt>おおさかちゃく</rt></ruby>	arriving at Osaka	Genki Kanji_Practice lesson-13 着,_同,_海,_and_昼
<ruby>同僚<rt>どうりょう</rt></ruby>	coworker	Genki Kanji_Practice lesson-13 着,_同,_海,_and_昼
<ruby>同級生<rt>どうきゅうせい</rt></ruby>	classmate	Genki Kanji_Practice lesson-13 着,_同,_海,_and_昼
<ruby>日本海<rt>にほんかい</rt></ruby>	the Japan Sea	Genki Kanji_Practice lesson-13 着,_同,_海,_and_昼
<ruby>海岸<rt>かいがん</rt></ruby>	coast	Genki Kanji_Practice lesson-13 着,_同,_海,_and_昼
<ruby>昼寝<rt>ひるね</rt></ruby>	nap	Genki Kanji_Practice lesson-13 着,_同,_海,_and_昼
<ruby>昼休み<rt>ひるやすみ</rt></ruby>	lunch break	Genki Kanji_Practice lesson-13 着,_同,_海,_and_昼
<ruby>昼食<rt>ちゅうしょく</rt></ruby>	lunch (formal)	Genki Kanji_Practice lesson-13 着,_同,_海,_and_昼
<ruby>口座<rt>こうざ</rt></ruby>	account	Bank_Words Genki lesson-13 Useful_Expressions
<ruby>手数料<rt>てすうりょう</rt></ruby>	commission	Bank_Words Genki lesson-13 Useful_Expressions
キャッシュカード	bank card	Bank_Words Genki lesson-13 Useful_Expressions
<ruby>預金<rt>よきん</rt></ruby>	savings	Bank_Words Genki lesson-13 Useful_Expressions
<ruby>百円玉<rt>ひゃくえんだま</rt></ruby>	100-yen coin	Bank_Words Genki lesson-13 Useful_Expressions
<ruby>金額<rt>きんがく</rt></ruby>	amount	Bank_Words Genki lesson-13 Useful_Expressions
<ruby>暗証番号<rt>あんしょうばんごう</rt></ruby>	personal identification number	Bank_Words Genki lesson-13 Useful_Expressions
<ruby>お預け入れ<rt>おあずけいれ</rt></ruby>	deposit	Bank_Words Genki lesson-13 Useful_Expressions
<ruby>お引き出し<rt>おひきだし</rt></ruby>	withdrawal	Bank_Words Genki lesson-13 Useful_Expressions
<ruby>口座を開きたいんですが。<rt>こうざをひらきたいんですが。</rt></ruby>	I would like to open an account.	At_the_Bank Genki lesson-13 Useful_Expressions
<ruby>口座を閉じたいんですが。<rt>こうざをとじたいんですが。</rt></ruby>	I would like to close an account.	At_the_Bank Genki lesson-13 Useful_Expressions
<ruby>ドルを円にかえてください。<rt>ドルを円にかえてください。</rt></ruby>	Please change dollars into yen.	At_the_Bank Genki lesson-13 Useful_Expressions
<ruby>口座にお金を振り込みたいんですが。<rt>こうざにおかねをふりこみたいんですが。</rt></ruby>	I would like to deposit money into the account.	At_the_Bank Genki lesson-13 Useful_Expressions
<ruby>一万円札を千円札十枚に両替できますか。<rt>いちまんえんさつをせんえんさつじゅうまいにりょうがえできますか。</rt></ruby>	Can you change a 10,000-yen bill into ten 1,000-yen bills?	At_the_Bank Genki lesson-13 Useful_Expressions
<ruby>お金をおろします。<rt>おかねをおろします。</rt></ruby>	I will withdraw money.	At_the_Bank Genki lesson-13 Useful_Expressions
<ruby>大家さん<rt>おおやさん</rt></ruby>	landlord; landlady	Genki lesson-14 Nouns_1 Vocabulary
<ruby>お返し<rt>おかえし</rt></ruby>	return (as a token of gratitude)	Genki lesson-14 Nouns_1 Vocabulary
<ruby>時代<rt>じだい</rt></ruby>	age; era	Genki Kanji_Practice lesson-14 彼,_代,_and_留
<ruby>九十年代<rt>きゅうじゅうねんだい</rt></ruby>	"90's"	Genki Kanji_Practice lesson-14 彼,_代,_and_留
<ruby>十代<rt>じゅうだい</rt></ruby>	"in one's teens"	Genki Kanji_Practice lesson-14 彼,_代,_and_留
<ruby>代わりに<rt>かわりに</rt></ruby>	instead	Genki Kanji_Practice lesson-14 彼,_代,_and_留
<ruby>留学生<rt>りゅうがくせい</rt></ruby>	foreign students	Genki Kanji_Practice lesson-14 彼,_代,_and_留
<ruby>留守<rt>るす</rt></ruby>	absence from home	Genki Kanji_Practice lesson-14 彼,_代,_and_留
ぬいぐるみ	stuffed animal	Genki lesson-14 Nouns_2 Vocabulary
<ruby>夫婦<rt>ふうふ</rt></ruby>	married couple; husband and wife	Genki lesson-14 Nouns_2 Vocabulary
<ruby>履歴書<rt>りれきしょ</rt></ruby>	resume; résumé	Genki lesson-14 Nouns_2 Vocabulary
<ruby>民族<rt>みんぞく</rt></ruby>	race	Genki Kanji_Practice lesson-14 族,_親,_and_切
<ruby>水族館<rt>すいぞくかん</rt></ruby>	aquarium	Genki Kanji_Practice lesson-14 族,_親,_and_切
<ruby>王族<rt>おうぞく</rt></ruby>	member of royalty	Genki Kanji_Practice lesson-14 族,_親,_and_切
<ruby>親切な<rt>しんせつな</rt></ruby>	kind	Genki Kanji_Practice lesson-14 族,_親,_and_切
<ruby>大切な<rt>たいせつな</rt></ruby>	precious	Genki Kanji_Practice lesson-14 族,_親,_and_切
<ruby>欲しい<rt>ほしい</rt></ruby>	to want	Adjectives_and_Verbs Genki lesson-14 Vocabulary
けち（な）	stingy; cheap	Adjectives_and_Verbs Genki lesson-14 Vocabulary
<ruby>送る<rt>おくる</rt></ruby>	to send	Adjectives_and_Verbs Genki lesson-14 Vocabulary
<ruby>似合う<rt>にあう</rt></ruby>	to look good (on somebody)	Adjectives_and_Verbs Genki lesson-14 Vocabulary
あきらめる	to give up	Adjectives_and_Verbs Genki lesson-14 Vocabulary
<ruby>英雄<rt>えいゆう</rt></ruby>	hero	Genki Kanji_Practice lesson-14 英,_店,_and_去
<ruby>店員<rt>てんいん</rt></ruby>	store attendant	Genki Kanji_Practice lesson-14 英,_店,_and_去
<ruby>過去<rt>かこ</rt></ruby>	the past	Genki Kanji_Practice lesson-14 英,_店,_and_去
<ruby>消去する<rt>しょうきょする</rt></ruby>	to erase	Genki Kanji_Practice lesson-14 英,_店,_and_去
こんな～	...like this; this kind of...	Adverbs_and_Other_Expressions Genki lesson-14 Vocabulary
どうしたらいい	what should one do	Adverbs_and_Other_Expressions Genki lesson-14 Vocabulary
よく	well	Adverbs_and_Other_Expressions Genki lesson-14 Vocabulary
<ruby>急に<rt>きゅうに</rt></ruby>	suddenly	Genki Kanji_Practice lesson-14 急,_乗,_and_当
<ruby>乗車<rt>じょうしゃ</rt></ruby>	riding a car	Genki Kanji_Practice lesson-14 急,_乗,_and_当
<ruby>乗馬<rt>じょうば</rt></ruby>	horseback riding	Genki Kanji_Practice lesson-14 急,_乗,_and_当
<ruby>当時<rt>とうじ</rt></ruby>	at that time	Genki Kanji_Practice lesson-14 急,_乗,_and_当
<ruby>～個<rt>～こ</rt></ruby>	[generic counter for smaller items]	Counters Genki lesson-14 Vocabulary
<ruby>～冊<rt>～さつ</rt></ruby>	[counter for bound volumes]	Counters Genki lesson-14 Vocabulary
<ruby>～台<rt>～だい</rt></ruby>	[counter for equipment]	Counters Genki lesson-14 Vocabulary
<ruby>～匹<rt>～ひき</rt></ruby>	[counter for smaller animals]	Counters Genki lesson-14 Vocabulary
<ruby>～本<rt>～ほん</rt></ruby>	[counter for long objects]	Counters Genki lesson-14 Vocabulary
<ruby>本音<rt>ほんね</rt></ruby>	real intention	Genki Kanji_Practice lesson-14 音,_楽,_医,_and_者
<ruby>楽な<rt>らくな</rt></ruby>	easy; comfortable	Genki Kanji_Practice lesson-14 音,_楽,_医,_and_者
<ruby>医院<rt>いいん</rt></ruby>	clinic	Genki Kanji_Practice lesson-14 音,_楽,_医,_and_者
<ruby>若者<rt>わかもの</rt></ruby>	young people	Genki Kanji_Practice lesson-14 音,_楽,_医,_and_者
<ruby>経験<rt>けいけん</rt></ruby>	experience	Genki lesson-15 Nouns_1 Vocabulary
<ruby>結婚式<rt>けっこんしき</rt></ruby>	wedding	Genki lesson-15 Nouns_1 Vocabulary
<ruby>地震<rt>じしん</rt></ruby>	earthquake	Genki lesson-15 Nouns_1 Vocabulary
<ruby>習慣<rt>しゅうかん</rt></ruby>	custom	Genki lesson-15 Nouns_1 Vocabulary
<ruby>必死<rt>ひっし</rt></ruby>	desperate	Genki Kanji_Practice lesson-15 死,_意,_and_味
<ruby>死者<rt>ししゃ</rt></ruby>	the dead	Genki Kanji_Practice lesson-15 死,_意,_and_味
<ruby>注意する<rt>ちゅういする</rt></ruby>	to watch out	Genki Kanji_Practice lesson-15 死,_意,_and_味
<ruby>用意する<rt>よういする</rt></ruby>	to prepare	Genki Kanji_Practice lesson-15 死,_意,_and_味
<ruby>趣味<rt>しゅみ</rt></ruby>	hobby	Genki Kanji_Practice lesson-15 死,_意,_and_味
<ruby>興味<rt>きょうみ</rt></ruby>	interest	Genki Kanji_Practice lesson-15 死,_意,_and_味
<ruby>味噌<rt>みそ</rt></ruby>	soybean paste	Genki Kanji_Practice lesson-15 死,_意,_and_味
<ruby>味<rt>あじ</rt></ruby>	taste	Genki Kanji_Practice lesson-15 死,_意,_and_味
<ruby>庭<rt>にわ</rt></ruby>	garden	Genki lesson-15 Nouns_2 Vocabulary
<ruby>割引券<rt>わりびきけん</rt></ruby>	discount coupon	Genki lesson-15 Nouns_2 Vocabulary
<ruby>注文する<rt>ちゅうもんする</rt></ruby>	to order	Genki Kanji_Practice lesson-15 注,_夏,_魚,_and_寺
<ruby>注ぐ<rt>そそぐ</rt></ruby>	to pour	Genki Kanji_Practice lesson-15 注,_夏,_魚,_and_寺
<ruby>夏休み<rt>なつやすみ</rt></ruby>	summer vacation	Genki Kanji_Practice lesson-15 注,_夏,_魚,_and_寺
<ruby>初夏<rt>しょか</rt></ruby>	early summer	Genki Kanji_Practice lesson-15 注,_夏,_魚,_and_寺
<ruby>魚市場<rt>うおいちば</rt></ruby>	fish market	Genki Kanji_Practice lesson-15 注,_夏,_魚,_and_寺
<ruby>金魚<rt>きんぎょ</rt></ruby>	gold fish	Genki Kanji_Practice lesson-15 注,_夏,_魚,_and_寺
<ruby>人魚<rt>にんぎょ</rt></ruby>	mermaid	Genki Kanji_Practice lesson-15 注,_夏,_魚,_and_寺
<ruby>寺院<rt>じいん</rt></ruby>	sacred building	Genki Kanji_Practice lesson-15 注,_夏,_魚,_and_寺
<ruby>禅寺<rt>ぜんでら</rt></ruby>	zen temple	Genki Kanji_Practice lesson-15 注,_夏,_魚,_and_寺
<ruby>広い<rt>ひろい</rt></ruby>	spacious; wide	Genki lesson-15 Vocabulary い-adjectives,_U-verbs,_and_Ru-Verbs
<ruby>下ろす<rt>おろす</rt></ruby>	to withdraw (money)	Genki lesson-15 Vocabulary い-adjectives,_U-verbs,_and_Ru-Verbs
<ruby>描く<rt>かく</rt></ruby>	to draw; to paint	Genki lesson-15 Vocabulary い-adjectives,_U-verbs,_and_Ru-Verbs
<ruby>探す<rt>さがす</rt></ruby>	to look for	Genki lesson-15 Vocabulary い-adjectives,_U-verbs,_and_Ru-Verbs
<ruby>誘う<rt>さそう</rt></ruby>	to invite	Genki lesson-15 Vocabulary い-adjectives,_U-verbs,_and_Ru-Verbs
しゃべる	to chat	Genki lesson-15 Vocabulary い-adjectives,_U-verbs,_and_Ru-Verbs
<ruby>付き合う<rt>つきあう</rt></ruby>	to date (someone); to keep company	Genki lesson-15 Vocabulary い-adjectives,_U-verbs,_and_Ru-Verbs
<ruby>保険に入る<rt>ほけんにはいる</rt></ruby>	to buy insurance	Genki lesson-15 Vocabulary い-adjectives,_U-verbs,_and_Ru-Verbs
<ruby>広場<rt>ひろば</rt></ruby>	square; open space	Genki Kanji_Practice lesson-15 広,_転,_and_借
<ruby>借地<rt>しゃくち</rt></ruby>	rented land	Genki Kanji_Practice lesson-15 広,_転,_and_借
<ruby>借金<rt>しゃっきん</rt></ruby>	debt	Genki Kanji_Practice lesson-15 広,_転,_and_借
<ruby>借家<rt>しゃくや</rt></ruby>	rented house	Genki Kanji_Practice lesson-15 広,_転,_and_借
<ruby>観光する<rt>かんこうする</rt></ruby>	to do sightseeing	Genki Irregular_Verbs,_Adverbs_and_Other_Expressions lesson-15 Vocabulary
<ruby>予約する<rt>よやくする</rt></ruby>	to reserve	Genki Irregular_Verbs,_Adverbs_and_Other_Expressions lesson-15 Vocabulary
～けど	...,but; ...,so	Genki Irregular_Verbs,_Adverbs_and_Other_Expressions lesson-15 Vocabulary
<ruby>～目<rt>～め</rt></ruby>	-th	Genki Irregular_Verbs,_Adverbs_and_Other_Expressions lesson-15 Vocabulary
<ruby>建物<rt>たてもの</rt></ruby>	building	Genki Kanji_Practice lesson-15 走,_建,_and_地
<ruby>建てる<rt>たてる</rt></ruby>	to build	Genki Kanji_Practice lesson-15 走,_建,_and_地
<ruby>建つ<rt>たつ</rt></ruby>	to be built	Genki Kanji_Practice lesson-15 走,_建,_and_地
<ruby>建国<rt>けんこく</rt></ruby>	founding a nation	Genki Kanji_Practice lesson-15 走,_建,_and_地
<ruby>地球<rt>ちきゅう</rt></ruby>	earth; globe	Genki Kanji_Practice lesson-15 走,_建,_and_地
<ruby>～泊<rt>～はく</rt></ruby>	...nights	At_the_Hotel Genki lesson-15 Useful_Expressions
<ruby>食事付<rt>しょくじつき</rt></ruby>	with meals	At_the_Hotel Genki lesson-15 Useful_Expressions
<ruby>一泊二食付<rt>いっぱくにしょくつき</rt></ruby>	one night with two meals	At_the_Hotel Genki lesson-15 Useful_Expressions
<ruby>禁煙ルーム<rt>きんえんルーム</rt></ruby>	non-smoking room	At_the_Hotel Genki lesson-15 Useful_Expressions
<ruby>喫煙ルーム<rt>きつえんルーム</rt></ruby>	smoking room	At_the_Hotel Genki lesson-15 Useful_Expressions
<ruby>二時まで荷物を預かってくれませんか。<rt>にじまでにもつをあずかってくれませんか。</rt></ruby>	"Could you keep my luggage until 2 o'clock?"	At_the_Hotel Genki lesson-15 Useful_Expressions
<ruby>場合<rt>ばあい</rt></ruby>	case	Genki Kanji_Practice lesson-15 場,_足,_and_通
<ruby>駐車場<rt>ちゅうしゃじょう</rt></ruby>	parking garage	Genki Kanji_Practice lesson-15 場,_足,_and_通
<ruby>一足<rt>いっそく</rt></ruby>	one pair of shoes	Genki Kanji_Practice lesson-15 場,_足,_and_通
<ruby>水不足<rt>みずぶそく</rt></ruby>	lack of water	Genki Kanji_Practice lesson-15 場,_足,_and_通
<ruby>通う<rt>かよう</rt></ruby>	to commute	Genki Kanji_Practice lesson-15 場,_足,_and_通
<ruby>通学<rt>つうがく</rt></ruby>	going to school	Genki Kanji_Practice lesson-15 場,_足,_and_通
<ruby>通勤<rt>つうきん</rt></ruby>	going to work	Genki Kanji_Practice lesson-15 場,_足,_and_通
<ruby>一人目<rt>ひとりめ</rt></ruby>	first person	Bonus_Vocabulary Genki lesson-15 ～目
<ruby>二人目<rt>ふたりめ</rt></ruby>	second person	Bonus_Vocabulary Genki lesson-15 ～目
<ruby>一枚目<rt>いちまいめ</rt></ruby>	first sheet	Bonus_Vocabulary Genki lesson-15 ～目
<ruby>二枚目<rt>にまいめ</rt></ruby>	second sheet	Bonus_Vocabulary Genki lesson-15 ～目
<ruby>三年目<rt>さんねんめ</rt></ruby>	third year	Bonus_Vocabulary Genki lesson-15 ～目
<ruby>一日目<rt>いちにちめ</rt></ruby>	first day	Bonus_Vocabulary Genki lesson-15 ～目
<ruby>駅員<rt>えきいん（さん）</rt></ruby>	station attendant	Genki lesson-16 Nouns Vocabulary
<ruby>大きさ<rt>おおきさ</rt></ruby>	size	Genki lesson-16 Nouns Vocabulary
<ruby>親<rt>おや</rt></ruby>	parent	Genki lesson-16 Nouns Vocabulary
<ruby>期末試験<rt>きまつしけん</rt></ruby>	final examination	Genki lesson-16 Nouns Vocabulary
ごみ	garbage	Genki lesson-16 Nouns Vocabulary
<ruby>砂糖<rt>さとう</rt></ruby>	sugar	Genki lesson-16 Nouns Vocabulary
<ruby>奨学金<rt>しょうがくきん</rt></ruby>	scholarship	Genki lesson-16 Nouns Vocabulary
<ruby>親せき<rt>しんせき</rt></ruby>	relatives	Genki lesson-16 Nouns Vocabulary
<ruby>推薦状<rt>すいせんじょう</rt></ruby>	letter of recommendation	Genki lesson-16 Nouns Vocabulary
<ruby>目覚まし時計<rt>めざましどけい</rt></ruby>	alarm clock	Genki lesson-16 Nouns Vocabulary
<ruby>供える<rt>そなえる</rt></ruby>	to offer; to sacrifice	Genki Kanji_Practice lesson-16 供,_世,_and_界
<ruby>提供<rt>ていきょう</rt></ruby>	offer	Genki Kanji_Practice lesson-16 供,_世,_and_界
<ruby>世話<rt>せわ</rt></ruby>	care	Genki Kanji_Practice lesson-16 供,_世,_and_界
<ruby>世代<rt>せだい</rt></ruby>	generation	Genki Kanji_Practice lesson-16 供,_世,_and_界
<ruby>三世<rt>さんせい</rt></ruby>	the third generation	Genki Kanji_Practice lesson-16 供,_世,_and_界
<ruby>世の中<rt>よのなか</rt></ruby>	the society	Genki Kanji_Practice lesson-16 供,_世,_and_界
<ruby>限界<rt>げんかい</rt></ruby>	limit	Genki Kanji_Practice lesson-16 供,_世,_and_界
<ruby>汚い<rt>きたない</rt></ruby>	dirty	Genki lesson-16 Vocabulary い-adjectives_and_U-verbs
<ruby>起こす<rt>おこす</rt></ruby>	to wake (someone) up	Genki lesson-16 Vocabulary い-adjectives_and_U-verbs
おごる	to treat (someone) to a meal	Genki lesson-16 Vocabulary い-adjectives_and_U-verbs
<ruby>落ち込む<rt>おちこむ</rt></ruby>	to get depressed	Genki lesson-16 Vocabulary い-adjectives_and_U-verbs
<ruby>困る<rt>こまる</rt></ruby>	to have difficulty	Genki lesson-16 Vocabulary い-adjectives_and_U-verbs
<ruby>直す<rt>なおす</rt></ruby>	to correct; to fix	Genki lesson-16 Vocabulary い-adjectives_and_U-verbs
<ruby>道に迷う<rt>みちにまよう</rt></ruby>	"to become lost; to lose one's way"	Genki lesson-16 Vocabulary い-adjectives_and_U-verbs
<ruby>迎えに行く<rt>むかえにいく</rt></ruby>	to go to pick up	Genki lesson-16 Vocabulary い-adjectives_and_U-verbs
<ruby>訳す<rt>やくす</rt></ruby>	to translate	Genki lesson-16 Vocabulary い-adjectives_and_U-verbs
<ruby>全て<rt>すべて</rt></ruby>	everything; all	Genki Kanji_Practice lesson-16 全,_部,_and_始
<ruby>部長<rt>ぶちょう</rt></ruby>	department manager	Genki Kanji_Practice lesson-16 全,_部,_and_始
<ruby>始発<rt>しはつ</rt></ruby>	first train	Genki Kanji_Practice lesson-16 全,_部,_and_始
<ruby>開始<rt>かいし</rt></ruby>	start	Genki Kanji_Practice lesson-16 全,_部,_and_始
<ruby>乗り遅れる<rt>のりおくれる</rt></ruby>	to miss (a train, bus, etc.)	Genki lesson-16 Ru-verbs_and_Irregular_verbs Vocabulary
<ruby>朝寝坊する<rt>あさねぼうする</rt></ruby>	to oversleep	Genki lesson-16 Ru-verbs_and_Irregular_verbs Vocabulary
<ruby>案内する<rt>あんないする</rt></ruby>	to show (someone) around	Genki lesson-16 Ru-verbs_and_Irregular_verbs Vocabulary
<ruby>説明する<rt>せつめいする</rt></ruby>	to explain	Genki lesson-16 Ru-verbs_and_Irregular_verbs Vocabulary
<ruby>二週目<rt>にしゅうめ</rt></ruby>	second week	Genki Kanji_Practice lesson-16 週,_以,_and_考
<ruby>～以外<rt>～いがい</rt></ruby>	other than...	Genki Kanji_Practice lesson-16 週,_以,_and_考
<ruby>～以内<rt>～いない</rt></ruby>	within...	Genki Kanji_Practice lesson-16 週,_以,_and_考
<ruby>以前<rt>いぜん</rt></ruby>	before; formerly	Genki Kanji_Practice lesson-16 週,_以,_and_考
ええと	well...; let me see...	Adverbs_and_Other_Expressions Genki lesson-16 Vocabulary
<ruby>今日中に<rt>きょうじゅうに</rt></ruby>	by the end of the day	Adverbs_and_Other_Expressions Genki lesson-16 Vocabulary
<ruby>この間<rt>このあいだ</rt></ruby>	the other day	Adverbs_and_Other_Expressions Genki lesson-16 Vocabulary
このぐらい	about this much	Adverbs_and_Other_Expressions Genki lesson-16 Vocabulary
これから	from now on	Adverbs_and_Other_Expressions Genki lesson-16 Vocabulary
<ruby>失礼します<rt>しつれいします</rt></ruby>	Excuse me.; Sorry to interrupt you.	Adverbs_and_Other_Expressions Genki lesson-16 Vocabulary
<ruby>授業中に<rt>じゅぎょうちゅうに</rt></ruby>	in class; during the class	Adverbs_and_Other_Expressions Genki lesson-16 Vocabulary
<ruby>開く<rt>ひらく</rt></ruby>	to open	Genki Kanji_Practice lesson-16 開,_屋,_and_方
<ruby>開店<rt>かいてん</rt></ruby>	opening of a store	Genki Kanji_Practice lesson-16 開,_屋,_and_方
<ruby>屋内<rt>おくない</rt></ruby>	indoor	Genki Kanji_Practice lesson-16 開,_屋,_and_方
<ruby>味方<rt>みかた</rt></ruby>	"person on one's side"	Genki Kanji_Practice lesson-16 開,_屋,_and_方
<ruby>両方<rt>りょうほう</rt></ruby>	both	Genki Kanji_Practice lesson-16 開,_屋,_and_方
<ruby>方法<rt>ほうほう</rt></ruby>	method	Genki Kanji_Practice lesson-16 開,_屋,_and_方
<ruby>運命<rt>うんめい</rt></ruby>	fate	Genki Kanji_Practice lesson-16 運,_動,_教,_and_室
<ruby>動く<rt>うごく</rt></ruby>	to move	Genki Kanji_Practice lesson-16 運,_動,_教,_and_室
<ruby>動詞<rt>どうし</rt></ruby>	verb	Genki Kanji_Practice lesson-16 運,_動,_教,_and_室
<ruby>教室<rt>きょうしつ</rt></ruby>	classroom	Genki Kanji_Practice lesson-16 運,_動,_教,_and_室
<ruby>キリスト教<rt>キリストきょう</rt></ruby>	Christianity	Genki Kanji_Practice lesson-16 運,_動,_教,_and_室
<ruby>研究室<rt>けんきゅうしつ</rt></ruby>	"professor's office"	Genki Kanji_Practice lesson-16 運,_動,_教,_and_室
<ruby>地下室<rt>ちかしつ</rt></ruby>	basement	Genki Kanji_Practice lesson-16 運,_動,_教,_and_室
<ruby>待合室<rt>まちあいしつ</rt></ruby>	waiting room	Genki Kanji_Practice lesson-16 運,_動,_教,_and_室
<ruby>お湯<rt>おゆ</rt></ruby>	hot water	Genki lesson-17 Nouns_1 Vocabulary
<ruby>最低<rt>さいてい</rt></ruby>	the lowest; the worst	Genki lesson-17 Nouns_1 Vocabulary
<ruby>残業<rt>ざんぎょう</rt></ruby>	overtime work	Genki lesson-17 Nouns_1 Vocabulary
<ruby>首相<rt>しゅしょう</rt></ruby>	prime minister	Genki lesson-17 Nouns_1 Vocabulary
<ruby>お歳暮<rt>おせいぼ</rt></ruby>	year-end gift	Genki Kanji_Practice lesson-17 歳,_習,_and_主
<ruby>二十歳<rt>はたち</rt></ruby>	twenty years old	Genki Kanji_Practice lesson-17 歳,_習,_and_主
<ruby>習字<rt>しゅうじ</rt></ruby>	calligraphy	Genki Kanji_Practice lesson-17 歳,_習,_and_主
<ruby>習慣<rt>しゅうかん</rt></ruby>	habit; custom	Genki Kanji_Practice lesson-17 歳,_習,_and_主
<ruby>主語<rt>しゅご</rt></ruby>	subject of a sentence	Genki Kanji_Practice lesson-17 歳,_習,_and_主
<ruby>持ち主<rt>もちぬし</rt></ruby>	owner	Genki Kanji_Practice lesson-17 歳,_習,_and_主
<ruby>違い<rt>ちがい</rt></ruby>	difference	Genki lesson-17 Nouns_2 Vocabulary
ひげ	beard	Genki lesson-17 Nouns_2 Vocabulary
<ruby>秘密<rt>ひみつ</rt></ruby>	secret	Genki lesson-17 Nouns_2 Vocabulary
<ruby>寮<rt>りょう</rt></ruby>	dorm	Genki lesson-17 Nouns_2 Vocabulary
<ruby>旅行会社<rt>りょこうがいしゃ</rt></ruby>	travel agency	Genki lesson-17 Nouns_2 Vocabulary
<ruby>結果<rt>けっか</rt></ruby>	result	Genki Kanji_Practice lesson-17 結,_婚,_and_集
<ruby>結論<rt>けつろん</rt></ruby>	conclusion	Genki Kanji_Practice lesson-17 結,_婚,_and_集
<ruby>結ぶ<rt>むすぶ</rt></ruby>	to tie a knot	Genki Kanji_Practice lesson-17 結,_婚,_and_集
<ruby>離婚<rt>りこん</rt></ruby>	divorce	Genki Kanji_Practice lesson-17 結,_婚,_and_集
<ruby>婚約者<rt>こんやくしゃ</rt></ruby>	fiancée	Genki Kanji_Practice lesson-17 結,_婚,_and_集
<ruby>危ない<rt>あぶない</rt></ruby>	dangerous	Genki lesson-17 Vocabulary い-adjectives_and_U-verbs
うらやましい	envious	Genki lesson-17 Vocabulary い-adjectives_and_U-verbs
<ruby>お湯を沸かす<rt>おゆをわかす</rt></ruby>	to boil water	Genki lesson-17 Vocabulary い-adjectives_and_U-verbs
<ruby>髪をとかす<rt>かみをとかす</rt></ruby>	"to comb one's hair"	Genki lesson-17 Vocabulary い-adjectives_and_U-verbs
<ruby>込む<rt>こむ</rt></ruby>	to get crowded	Genki lesson-17 Vocabulary い-adjectives_and_U-verbs
<ruby>宝くじに当たる<rt>たからくじにあたる</rt></ruby>	to win a lottery	Genki lesson-17 Vocabulary い-adjectives_and_U-verbs
<ruby>脱ぐ<rt>ぬぐ</rt></ruby>	to take off (clothes)	Genki lesson-17 Vocabulary い-adjectives_and_U-verbs
ひげをそる	"to shave one's beard"	Genki lesson-17 Vocabulary い-adjectives_and_U-verbs
<ruby>出発<rt>しゅっぱつ</rt></ruby>	departure	Genki Kanji_Practice lesson-17 発,_表,_and_品
<ruby>表紙<rt>ひょうし</rt></ruby>	cover page	Genki Kanji_Practice lesson-17 発,_表,_and_品
<ruby>上品な<rt>じょうひんな</rt></ruby>	elegant	Genki Kanji_Practice lesson-17 発,_表,_and_品
<ruby>手品<rt>てじな</rt></ruby>	magic	Genki Kanji_Practice lesson-17 発,_表,_and_品
<ruby>品物<rt>しなもの</rt></ruby>	merchandise article	Genki Kanji_Practice lesson-17 発,_表,_and_品
いれる	to make tea, coffee, etc.	Genki lesson-17 Ru-verbs_and_Irregular_verbs Vocabulary
かぎをかける	to lock	Genki lesson-17 Ru-verbs_and_Irregular_verbs Vocabulary
<ruby>慣れる<rt>なれる</rt></ruby>	to get used to...	Genki lesson-17 Ru-verbs_and_Irregular_verbs Vocabulary
<ruby>お祈りする<rt>おいのりする</rt></ruby>	to pray	Genki lesson-17 Ru-verbs_and_Irregular_verbs Vocabulary
<ruby>化粧する<rt>けしょうする</rt></ruby>	to put makeup on	Genki lesson-17 Ru-verbs_and_Irregular_verbs Vocabulary
<ruby>就職する<rt>しゅうしょくする</rt></ruby>	to get a full-time job (at...)	Genki lesson-17 Ru-verbs_and_Irregular_verbs Vocabulary
<ruby>赤字<rt>あかじ</rt></ruby>	deficit	Genki Kanji_Practice lesson-17 字,_活,_and_写
<ruby>活動<rt>かつどう</rt></ruby>	activity	Genki Kanji_Practice lesson-17 字,_活,_and_写
<ruby>活発な<rt>かっぱつな</rt></ruby>	active	Genki Kanji_Practice lesson-17 字,_活,_and_写
<ruby>活気<rt>かっき</rt></ruby>	liveliness	Genki Kanji_Practice lesson-17 字,_活,_and_写
おめでとうございます	Congratulations!	Adverbs_and_Other_Expressions Genki lesson-17 Vocabulary
～かな（あ）	I wonder... (casual)	Adverbs_and_Other_Expressions Genki lesson-17 Vocabulary
ずいぶん	very	Adverbs_and_Other_Expressions Genki lesson-17 Vocabulary
そうか	I see. (casual)	Adverbs_and_Other_Expressions Genki lesson-17 Vocabulary
それに	moreover,...	Adverbs_and_Other_Expressions Genki lesson-17 Vocabulary
<ruby>～に比べて<rt>～にくらべて</rt></ruby>	compared with...	Adverbs_and_Other_Expressions Genki lesson-17 Vocabulary
～によると	according to...	Adverbs_and_Other_Expressions Genki lesson-17 Vocabulary
<ruby>前<rt>まえ</rt></ruby>	before	Adverbs_and_Other_Expressions Genki lesson-17 Vocabulary
やっぱり	after all	Adverbs_and_Other_Expressions Genki lesson-17 Vocabulary
<ruby>真ん中<rt>まんなか</rt></ruby>	center	Genki Kanji_Practice lesson-17 真,_歩,_and_野
<ruby>～の真上<rt>～のまうえ</rt></ruby>	right above...	Genki Kanji_Practice lesson-17 真,_歩,_and_野
<ruby>進歩<rt>しんぽ</rt></ruby>	progress	Genki Kanji_Practice lesson-17 真,_歩,_and_野
<ruby>分野<rt>ぶんや</rt></ruby>	realm; field	Genki Kanji_Practice lesson-17 真,_歩,_and_野
<ruby>あまり短くしないでください。<rt>あまりみじかくしないでください。</rt></ruby>	"Please don't make it too short."	At_the_Barber/Beauty_Salon Genki lesson-17 Useful_Expressions
そらないでください。	"Please don't shave."	At_the_Barber/Beauty_Salon Genki lesson-17 Useful_Expressions
<ruby>３センチぐらい切ってください。<rt>３センチぐらいきってください。</rt></ruby>	Please cut off about 3 centimeters.	At_the_Barber/Beauty_Salon Genki lesson-17 Useful_Expressions
<ruby>後ろをそろえてください。<rt>うしろをそろえてください。</rt></ruby>	Please cut the back all the same length.	At_the_Barber/Beauty_Salon Genki lesson-17 Useful_Expressions
カット	cut	Barber/Beauty_Salon_Words Genki lesson-17 Useful_Expressions
<ruby>髪形<rt>かみがた</rt></ruby>	hair style	Barber/Beauty_Salon_Words Genki lesson-17 Useful_Expressions
もみあげ	sideburns	Barber/Beauty_Salon_Words Genki lesson-17 Useful_Expressions
<ruby>分け目<rt>わけめ</rt></ruby>	parting (of the hair)	Barber/Beauty_Salon_Words Genki lesson-17 Useful_Expressions
<ruby>前髪<rt>まえがみ</rt></ruby>	bangs	Barber/Beauty_Salon_Words Genki lesson-17 Useful_Expressions
<ruby>刈る<rt>かる</rt></ruby>	to crop	Barber/Beauty_Salon_Words Genki lesson-17 Useful_Expressions
そめる	to dye	Barber/Beauty_Salon_Words Genki lesson-17 Useful_Expressions
そろえる	to make hair even; to trim	Barber/Beauty_Salon_Words Genki lesson-17 Useful_Expressions
<ruby>目的<rt>もくてき</rt></ruby>	purpose	Genki Kanji_Practice lesson-18 目,_的,_and_力
<ruby>目薬<rt>めぐすり</rt></ruby>	eye drops	Genki Kanji_Practice lesson-18 目,_的,_and_力
<ruby>二番目<rt>にばんめ</rt></ruby>	the second	Genki Kanji_Practice lesson-18 目,_的,_and_力
<ruby>目上の人<rt>めうえのひと</rt></ruby>	"one's superiors"	Genki Kanji_Practice lesson-18 目,_的,_and_力
<ruby>現代的<rt>げんだいてき</rt></ruby>	modern	Genki Kanji_Practice lesson-18 目,_的,_and_力
<ruby>社会的<rt>しゃかいてき</rt></ruby>	social	Genki Kanji_Practice lesson-18 目,_的,_and_力
<ruby>的<rt>まと</rt></ruby>	target	Genki Kanji_Practice lesson-18 目,_的,_and_力
<ruby>力仕事<rt>ちからしごと</rt></ruby>	physical labor	Genki Kanji_Practice lesson-18 目,_的,_and_力
<ruby>協力<rt>きょうりょく</rt></ruby>	cooperation	Genki Kanji_Practice lesson-18 目,_的,_and_力
<ruby>努力<rt>どりょく</rt></ruby>	endeavor	Genki Kanji_Practice lesson-18 目,_的,_and_力
<ruby>力士<rt>りきし</rt></ruby>	sumo wrestler	Genki Kanji_Practice lesson-18 目,_的,_and_力
<ruby>家賃<rt>やちん</rt></ruby>	rent	Genki lesson-18 Nouns_2 Vocabulary
<ruby>冷蔵庫<rt>れいぞうこ</rt></ruby>	refrigerator	Genki lesson-18 Nouns_2 Vocabulary
ろうそく	candle	Genki lesson-18 Nouns_2 Vocabulary
<ruby>洋服<rt>ようふく</rt></ruby>	Western clothes	Genki Kanji_Practice lesson-18 洋,_服,_堂,_and_授
<ruby>洋食<rt>ようしょく</rt></ruby>	Western food	Genki Kanji_Practice lesson-18 洋,_服,_堂,_and_授
<ruby>大西洋<rt>たいせいよう</rt></ruby>	the Atlantic	Genki Kanji_Practice lesson-18 洋,_服,_堂,_and_授
<ruby>制服<rt>せいふく</rt></ruby>	uniform	Genki Kanji_Practice lesson-18 洋,_服,_堂,_and_授
<ruby>公会堂<rt>こうかいどう</rt></ruby>	public hall	Genki Kanji_Practice lesson-18 洋,_服,_堂,_and_授
<ruby>堂々とした<rt>どうどうとした</rt></ruby>	dignified; imposing	Genki Kanji_Practice lesson-18 洋,_服,_堂,_and_授
<ruby>暗い<rt>くらい</rt></ruby>	dark	Genki lesson-18 Vocabulary い-adjectives_and_U-verbs
<ruby>恥ずかしい<rt>はずかしい</rt></ruby>	embarrassing; to feel embarrassed	Genki lesson-18 Vocabulary い-adjectives_and_U-verbs
<ruby>押す<rt>おす</rt></ruby>	to press; to push	Genki lesson-18 Vocabulary い-adjectives_and_U-verbs
<ruby>お湯が沸く<rt>おゆがわく</rt></ruby>	water boils	Genki lesson-18 Vocabulary い-adjectives_and_U-verbs
<ruby>転ぶ<rt>ころぶ</rt></ruby>	to fall down	Genki lesson-18 Vocabulary い-adjectives_and_U-verbs
<ruby>壊す<rt>こわす</rt></ruby>	to break (something)	Genki lesson-18 Vocabulary い-adjectives_and_U-verbs
<ruby>咲く<rt>さく</rt></ruby>	to bloom	Genki lesson-18 Vocabulary い-adjectives_and_U-verbs
<ruby>閉まる<rt>しまる</rt></ruby>	(something) closes	Genki lesson-18 Vocabulary い-adjectives_and_U-verbs
<ruby>頼む<rt>たのむ</rt></ruby>	to ask (a favor)	Genki lesson-18 Vocabulary い-adjectives_and_U-verbs
<ruby>汚す<rt>よごす</rt></ruby>	to make dirty	Genki lesson-18 Vocabulary い-adjectives_and_U-verbs
<ruby>職業<rt>しょくぎょう</rt></ruby>	occupation	Genki Kanji_Practice lesson-18 業,_試,_and_験
<ruby>産業<rt>さんぎょう</rt></ruby>	industry	Genki Kanji_Practice lesson-18 業,_試,_and_験
<ruby>入試<rt>にゅうし</rt></ruby>	entrance exam	Genki Kanji_Practice lesson-18 業,_試,_and_験
<ruby>試みる<rt>こころみる</rt></ruby>	to try	Genki Kanji_Practice lesson-18 業,_試,_and_験
<ruby>落ちる<rt>おちる</rt></ruby>	(something) drops	Genki lesson-18 Ru-verbs_and_Irregular_verbs Vocabulary
<ruby>片付ける<rt>かたづける</rt></ruby>	to tidy up	Genki lesson-18 Ru-verbs_and_Irregular_verbs Vocabulary
<ruby>消える<rt>きえる</rt></ruby>	(something) goes off	Genki lesson-18 Ru-verbs_and_Irregular_verbs Vocabulary
<ruby>壊れる<rt>こわれる</rt></ruby>	(something) breaks	Genki lesson-18 Ru-verbs_and_Irregular_verbs Vocabulary
<ruby>汚れる<rt>よごれる</rt></ruby>	to become dirty	Genki lesson-18 Ru-verbs_and_Irregular_verbs Vocabulary
<ruby>注文する<rt>ちゅうもんする</rt></ruby>	to place an order	Genki lesson-18 Ru-verbs_and_Irregular_verbs Vocabulary
<ruby>貸し出し<rt>かしだし</rt></ruby>	lending	Genki Kanji_Practice lesson-18 貸,_図,_and_館
<ruby>賃貸マンション<rt>ちんたいマンション</rt></ruby>	apartment for rent	Genki Kanji_Practice lesson-18 貸,_図,_and_館
<ruby>合図<rt>あいず</rt></ruby>	signal	Genki Kanji_Practice lesson-18 貸,_図,_and_館
<ruby>図る<rt>はかる</rt></ruby>	to attempt	Genki Kanji_Practice lesson-18 貸,_図,_and_館
おかげで	thanks to...	Adverbs_and_Other_Expressions Genki lesson-18 Vocabulary
<ruby>お先に失礼します<rt>おさきにしつれいします</rt></ruby>	"See you. (lit., I'm leaving ahead of you.)"	Adverbs_and_Other_Expressions Genki lesson-18 Vocabulary
どうしよう	What should I/we do?	Adverbs_and_Other_Expressions Genki lesson-18 Vocabulary
～までに	by (time/date)	Adverbs_and_Other_Expressions Genki lesson-18 Vocabulary
<ruby>終わる<rt>おわる</rt></ruby>	to come to an end	Genki Kanji_Practice lesson-18 終,_宿,_and_題
<ruby>下宿<rt>げしゅく</rt></ruby>	boarding house	Genki Kanji_Practice lesson-18 終,_宿,_and_題
<ruby>宿泊<rt>しゅくはく</rt></ruby>	lodging	Genki Kanji_Practice lesson-18 終,_宿,_and_題
<ruby>宿<rt>やど</rt></ruby>	inn	Genki Kanji_Practice lesson-18 終,_宿,_and_題
<ruby>問題<rt>もんだい</rt></ruby>	problem; question	Genki Kanji_Practice lesson-18 終,_宿,_and_題
<ruby>話題<rt>わだい</rt></ruby>	topic of conversation	Genki Kanji_Practice lesson-18 終,_宿,_and_題
<ruby>題<rt>だい</rt></ruby>	title	Genki Kanji_Practice lesson-18 終,_宿,_and_題
<ruby>奥様<rt>おくさま</rt></ruby>	(your/his) wife (polite)	Genki lesson-19 Nouns_1 Vocabulary
<ruby>お子さん<rt>おこさん</rt></ruby>	(your/their) child (polite)	Genki lesson-19 Nouns_1 Vocabulary
<ruby>お礼<rt>おれい</rt></ruby>	expression of gratitude	Genki lesson-19 Nouns_1 Vocabulary
<ruby>敬語<rt>けいご</rt></ruby>	honorific language	Genki lesson-19 Nouns_1 Vocabulary
こちら	this way (polite)	Genki lesson-19 Nouns_1 Vocabulary
<ruby>出張<rt>しゅっちょう</rt></ruby>	business trip	Genki lesson-19 Nouns_1 Vocabulary
<ruby>種類<rt>しゅるい</rt></ruby>	a kind; a sort	Genki lesson-19 Nouns_1 Vocabulary
<ruby>性格<rt>せいかく</rt></ruby>	personality	Genki lesson-19 Nouns_1 Vocabulary
<ruby>中学生<rt>ちゅうがくせい</rt></ruby>	junior high school student	Genki lesson-19 Nouns_1 Vocabulary
<ruby>春巻<rt>はるまき</rt></ruby>	spring roll	Genki Kanji_Practice lesson-19 春,_秋,_and_冬
<ruby>青春<rt>せいしゅん</rt></ruby>	youth	Genki Kanji_Practice lesson-19 春,_秋,_and_冬
<ruby>秋<rt>あき</rt></ruby>	autumn	Genki Kanji_Practice lesson-19 春,_秋,_and_冬
<ruby>秋学期<rt>あきがっき</rt></ruby>	fall semester	Genki Kanji_Practice lesson-19 春,_秋,_and_冬
<ruby>暖冬<rt>だんとう</rt></ruby>	warm winter	Genki Kanji_Practice lesson-19 春,_秋,_and_冬
<ruby>春夏秋冬<rt>しゅんかしゅうとう</rt></ruby>	four seasons	Genki Kanji_Practice lesson-19 春,_秋,_and_冬
どちら	where (polite)	Genki lesson-19 Nouns_2_and_Adjectives Vocabulary
<ruby>怠け者<rt>なまけもの</rt></ruby>	lazy person	Genki lesson-19 Nouns_2_and_Adjectives Vocabulary
<ruby>悩み<rt>なやみ</rt></ruby>	worry	Genki lesson-19 Nouns_2_and_Adjectives Vocabulary
<ruby>恥ずかしがり屋<rt>はずかしがりや</rt></ruby>	shy person	Genki lesson-19 Nouns_2_and_Adjectives Vocabulary
<ruby>間違い<rt>まちがい</rt></ruby>	mistake	Genki lesson-19 Nouns_2_and_Adjectives Vocabulary
<ruby>仲がいい<rt>なかがいい</rt></ruby>	be on good terms; to get along well	Genki lesson-19 Nouns_2_and_Adjectives Vocabulary
まじめ（な）	serious; sober; diligent	Genki lesson-19 Nouns_2_and_Adjectives Vocabulary
<ruby>花粉症<rt>かふんしょう</rt></ruby>	hay fever	Genki Kanji_Practice lesson-19 花,_様,_and_不
<ruby>生け花<rt>いけばな</rt></ruby>	flower arrangement	Genki Kanji_Practice lesson-19 花,_様,_and_不
<ruby>様子<rt>ようす</rt></ruby>	manner	Genki Kanji_Practice lesson-19 花,_様,_and_不
<ruby>不安な<rt>ふあんな</rt></ruby>	uneasy; worried	Genki Kanji_Practice lesson-19 花,_様,_and_不
<ruby>不景気<rt>ふけいき</rt></ruby>	recession	Genki Kanji_Practice lesson-19 花,_様,_and_不
<ruby>不便<rt>ふべん</rt></ruby>	inconvenience	Genki Kanji_Practice lesson-19 花,_様,_and_不
<ruby>水不足<rt>みずぶそく</rt></ruby>	water shortage	Genki Kanji_Practice lesson-19 花,_様,_and_不
<ruby>怒る<rt>おこる</rt></ruby>	to get angry	Genki lesson-19 U-verbs Vocabulary
おっしゃる	honorific expression for いう	Genki lesson-19 U-verbs Vocabulary
<ruby>お休みになる<rt>おやすみになる</rt></ruby>	honorific expression for ねる	Genki lesson-19 U-verbs Vocabulary
<ruby>下さる<rt>くださる</rt></ruby>	honorific expression for くれる	Genki lesson-19 U-verbs Vocabulary
<ruby>ご覧になる<rt>ごらんになる</rt></ruby>	honorific expression for みる	Genki lesson-19 U-verbs Vocabulary
<ruby>知り合う<rt>しりあう</rt></ruby>	to get acquainted with	Genki lesson-19 U-verbs Vocabulary
～ていらっしゃる	honorific expression for ～ている	Genki lesson-19 U-verbs Vocabulary
なさる	honorific expression for する	Genki lesson-19 U-verbs Vocabulary
<ruby>引っ越す<rt>ひっこす</rt></ruby>	to move (to another place to live)	Genki lesson-19 U-verbs Vocabulary
<ruby>召し上がる<rt>めしあがる</rt></ruby>	honorific expression for たべる and のむ	Genki lesson-19 U-verbs Vocabulary
<ruby>呼ぶ<rt>よぶ</rt></ruby>	"to call (one's name); to invite"	Genki lesson-19 U-verbs Vocabulary
<ruby>寄る<rt>よる</rt></ruby>	to stop by	Genki lesson-19 U-verbs Vocabulary
<ruby>姉妹都市<rt>しまいとし</rt></ruby>	sister city	Genki Kanji_Practice lesson-19 姉,_兄,_漢,_and_卒
<ruby>遅れる<rt>おくれる</rt></ruby>	to become late	Genki lesson-19 Ru-verbs_and_Irregular_verbs Vocabulary
かける	to sit down	Genki lesson-19 Ru-verbs_and_Irregular_verbs Vocabulary
<ruby>晴れる<rt>はれる</rt></ruby>	to become sunny	Genki lesson-19 Ru-verbs_and_Irregular_verbs Vocabulary
もてる	to be popular (in terms of romantic interest)	Genki lesson-19 Ru-verbs_and_Irregular_verbs Vocabulary
ごちそうする	to treat/invite (someone) to a meal	Genki lesson-19 Ru-verbs_and_Irregular_verbs Vocabulary
<ruby>招待する<rt>しょうたいする</rt></ruby>	to invite someone (to an event/a place)	Genki lesson-19 Ru-verbs_and_Irregular_verbs Vocabulary
<ruby>注意する<rt>ちゅういする</rt></ruby>	to watch out; to give warning	Genki lesson-19 Ru-verbs_and_Irregular_verbs Vocabulary
<ruby>話をする<rt>はなしをする</rt></ruby>	to have a talk	Genki lesson-19 Ru-verbs_and_Irregular_verbs Vocabulary
<ruby>大工<rt>だいく</rt></ruby>	carpenter	Genki Kanji_Practice lesson-19 工,_研,_and_究
<ruby>研修<rt>けんしゅう</rt></ruby>	training	Genki Kanji_Practice lesson-19 工,_研,_and_究
<ruby>研ぐ<rt>とぐ</rt></ruby>	to sharpen	Genki Kanji_Practice lesson-19 工,_研,_and_究
<ruby>探究<rt>たんきゅう</rt></ruby>	inquiry	Genki Kanji_Practice lesson-19 工,_研,_and_究
<ruby>究める<rt>きわめる</rt></ruby>	to investigate thoroughly	Genki Kanji_Practice lesson-19 工,_研,_and_究
それで	then; therefore	Adverbs_and_Other_Expressions Genki lesson-19 Vocabulary
まだ	still	Adverbs_and_Other_Expressions Genki lesson-19 Vocabulary
<ruby>～名様<rt>～めいさま</rt></ruby>	party of...people	Adverbs_and_Other_Expressions Genki lesson-19 Vocabulary
ようこそ	Welcome.	Adverbs_and_Other_Expressions Genki lesson-19 Vocabulary
<ruby>質問<rt>しつもん</rt></ruby>	question	Genki Kanji_Practice lesson-19 質,_問,_and_多
<ruby>質がいい<rt>しつがいい</rt></ruby>	good quality	Genki Kanji_Practice lesson-19 質,_問,_and_多
<ruby>素質<rt>そしつ</rt></ruby>	aptitude	Genki Kanji_Practice lesson-19 質,_問,_and_多
<ruby>質屋<rt>しちや</rt></ruby>	pawn shop	Genki Kanji_Practice lesson-19 質,_問,_and_多
<ruby>問題<rt>もんだい</rt></ruby>	problem	Genki Kanji_Practice lesson-19 質,_問,_and_多
<ruby>訪問<rt>ほうもん</rt></ruby>	visit	Genki Kanji_Practice lesson-19 質,_問,_and_多
<ruby>問う<rt>とう</rt></ruby>	to question	Genki Kanji_Practice lesson-19 質,_問,_and_多
<ruby>昨年は大変お世話になりました<rt>さくねんはたいへんおせわになりました</rt></ruby>	Thank you for all your kind help during the past year.	Genki Greeting_Cards lesson-19 Useful_Expressions
<ruby>本年もどうぞよろしくお願いいたします<rt>ほんねんもどうぞよろしくおねがいいたします</rt></ruby>	I hope for your continued good will this year.	Genki Greeting_Cards lesson-19 Useful_Expressions
<ruby>暑中お見舞い申し上げます<rt>しょちゅうおみまいもうしあげます</rt></ruby>	I hope you are keeping well during the hot weather.	Genki Greeting_Cards lesson-19 Useful_Expressions
<ruby>ご卒業おめでとうございます<rt>ごそつぎょうおめでとうございます</rt></ruby>	Congratulations on your graduation.	Genki Greeting_Cards lesson-19 Useful_Expressions
<ruby>ご結婚おめでとうございます<rt>ごけっこんおめでとうございます</rt></ruby>	Congratulations on your marriage.	Genki Greeting_Cards lesson-19 Useful_Expressions
<ruby>早くよくなってください<rt>はやくよくなってください</rt></ruby>	Get well soon.	Genki Greeting_Cards lesson-19 Useful_Expressions
あちら	that way (polite)	Genki lesson-20 Nouns_1 Vocabulary
<ruby>宇宙人<rt>うちゅうじん</rt></ruby>	space alien	Genki lesson-20 Nouns_1 Vocabulary
おにぎり	rice ball	Genki lesson-20 Nouns_1 Vocabulary
<ruby>係の者<rt>かかりのもの</rt></ruby>	our person in charge	Genki lesson-20 Nouns_1 Vocabulary
<ruby>支店<rt>してん</rt></ruby>	branch office	Genki lesson-20 Nouns_1 Vocabulary
<ruby>紙皿<rt>かみざら</rt></ruby>	paper plate	Genki Kanji_Practice lesson-20 皿,_声,_and_茶
<ruby>灰皿<rt>はいざら</rt></ruby>	ashtray	Genki Kanji_Practice lesson-20 皿,_声,_and_茶
<ruby>音声学<rt>おんせいがく</rt></ruby>	phonetics	Genki Kanji_Practice lesson-20 皿,_声,_and_茶
<ruby>擬声語<rt>ぎせいご</rt></ruby>	onomatopoeia	Genki Kanji_Practice lesson-20 皿,_声,_and_茶
<ruby>声優<rt>せいゆう</rt></ruby>	voice actor	Genki Kanji_Practice lesson-20 皿,_声,_and_茶
<ruby>お茶<rt>おちゃ</rt></ruby>	Japanese tea	Genki Kanji_Practice lesson-20 皿,_声,_and_茶
<ruby>茶店<rt>ちゃみせ</rt></ruby>	teahouse	Genki Kanji_Practice lesson-20 皿,_声,_and_茶
<ruby>小説<rt>しょうせつ</rt></ruby>	novel	Genki lesson-20 Nouns_2_and_い-adjectives Vocabulary
<ruby>信号<rt>しんごう</rt></ruby>	traffic light	Genki lesson-20 Nouns_2_and_い-adjectives Vocabulary
<ruby>扇子<rt>せんす</rt></ruby>	fan	Genki lesson-20 Nouns_2_and_い-adjectives Vocabulary
<ruby>中止する<rt>ちゅうしする</rt></ruby>	to cancel	Genki Kanji_Practice lesson-20 止,_枚,_and_両
<ruby>禁止する<rt>きんしする</rt></ruby>	to prohibit	Genki Kanji_Practice lesson-20 止,_枚,_and_両
<ruby>一枚<rt>いちまい</rt></ruby>	one sheet	Genki Kanji_Practice lesson-20 止,_枚,_and_両
<ruby>枚数<rt>まいすう</rt></ruby>	number of flat things	Genki Kanji_Practice lesson-20 止,_枚,_and_両
<ruby>両替<rt>りょうがえ</rt></ruby>	exchange	Genki Kanji_Practice lesson-20 止,_枚,_and_両
<ruby>致す<rt>いたす</rt></ruby>	extra-modest expression for する	Genki lesson-20 U-verbs Vocabulary
<ruby>頂く<rt>いただく</rt></ruby>	extra-modest exp. for たべる and のむ/humble exp. for もらう	Genki lesson-20 U-verbs Vocabulary
<ruby>伺う<rt>うかがう</rt></ruby>	to humbly visit; to humbly ask	Genki lesson-20 U-verbs Vocabulary
おる	extra-modest expression for いる	Genki lesson-20 U-verbs Vocabulary
ござる	extra-modest expression for ある	Genki lesson-20 U-verbs Vocabulary
～ておる	extra-modest expression for ～ている	Genki lesson-20 U-verbs Vocabulary
～でござる	extra-modest expression for です	Genki lesson-20 U-verbs Vocabulary
<ruby>参る<rt>まいる</rt></ruby>	extra-modest expression for いく and くる	Genki lesson-20 U-verbs Vocabulary
<ruby>申す<rt>もうす</rt></ruby>	extra-modest expression for いう	Genki lesson-20 U-verbs Vocabulary
<ruby>戻る<rt>もどる</rt></ruby>	to return; to come back	Genki lesson-20 U-verbs Vocabulary
<ruby>無駄な<rt>むだな</rt></ruby>	wasteful	Genki Kanji_Practice lesson-20 無,_払,_and_心
<ruby>無料<rt>むりょう</rt></ruby>	free of charge	Genki Kanji_Practice lesson-20 無,_払,_and_心
<ruby>無礼な<rt>ぶれいな</rt></ruby>	rude	Genki Kanji_Practice lesson-20 無,_払,_and_心
<ruby>無い<rt>ない</rt></ruby>	there is no...	Genki Kanji_Practice lesson-20 無,_払,_and_心
<ruby>支払い<rt>しはらい</rt></ruby>	payment	Genki Kanji_Practice lesson-20 無,_払,_and_心
<ruby>払い戻し<rt>はらいもどし</rt></ruby>	refund	Genki Kanji_Practice lesson-20 無,_払,_and_心
<ruby>分割払い<rt>ぶんかつばらい</rt></ruby>	payment in installments	Genki Kanji_Practice lesson-20 無,_払,_and_心
<ruby>熱心な<rt>ねっしんな</rt></ruby>	enthusiastic	Genki Kanji_Practice lesson-20 無,_払,_and_心
<ruby>安心な<rt>あんしんな</rt></ruby>	safe	Genki Kanji_Practice lesson-20 無,_払,_and_心
<ruby>好奇心<rt>こうきしん</rt></ruby>	curiosity	Genki Kanji_Practice lesson-20 無,_払,_and_心
<ruby>聞こえる<rt>きこえる</rt></ruby>	to be audible	Genki lesson-20 Ru-verbs_and_Irregular_verbs Vocabulary
<ruby>差し上げる<rt>さしあげる</rt></ruby>	humble expression for あげる	Genki lesson-20 Ru-verbs_and_Irregular_verbs Vocabulary
<ruby>伝える<rt>つたえる</rt></ruby>	to convey (message)	Genki lesson-20 Ru-verbs_and_Irregular_verbs Vocabulary
<ruby>待たせる<rt>またせる</rt></ruby>	to keep (someone) waiting	Genki lesson-20 Ru-verbs_and_Irregular_verbs Vocabulary
<ruby>交換する<rt>こうかんする</rt></ruby>	to exchange	Genki lesson-20 Ru-verbs_and_Irregular_verbs Vocabulary
<ruby>返品する<rt>へんぴんする</rt></ruby>	to return (merchandise)	Genki lesson-20 Ru-verbs_and_Irregular_verbs Vocabulary
<ruby>笑顔<rt>えがお</rt></ruby>	smile	Genki Kanji_Practice lesson-20 笑,_絶,_and_対
<ruby>微笑む<rt>ほほえむ</rt></ruby>	to smile	Genki Kanji_Practice lesson-20 笑,_絶,_and_対
<ruby>爆笑する<rt>ばくしょうする</rt></ruby>	to burst into laughter	Genki Kanji_Practice lesson-20 笑,_絶,_and_対
<ruby>絶対に<rt>ぜったいに</rt></ruby>	definitely	Genki Kanji_Practice lesson-20 笑,_絶,_and_対
<ruby>絶える<rt>たえる</rt></ruby>	to die out	Genki Kanji_Practice lesson-20 笑,_絶,_and_対
<ruby>絶滅<rt>ぜつめつ</rt></ruby>	extinction	Genki Kanji_Practice lesson-20 笑,_絶,_and_対
<ruby>気絶する<rt>きぜつする</rt></ruby>	to faint	Genki Kanji_Practice lesson-20 笑,_絶,_and_対
<ruby>絶望<rt>ぜつぼう</rt></ruby>	despair	Genki Kanji_Practice lesson-20 笑,_絶,_and_対
<ruby>一対<rt>いっつい</rt></ruby>	a pair	Genki Kanji_Practice lesson-20 笑,_絶,_and_対
おや？	Oh!	Adverbs_and_Other_Expressions Genki lesson-20 Vocabulary
<ruby>～階<rt>～かい</rt></ruby>	...th floor	Adverbs_and_Other_Expressions Genki lesson-20 Vocabulary
かしこまりました	Certainly.	Adverbs_and_Other_Expressions Genki lesson-20 Vocabulary
さあ	I am not sure,...	Adverbs_and_Other_Expressions Genki lesson-20 Vocabulary
<ruby>失礼しました<rt>しつれいしました</rt></ruby>	"I'm very sorry."	Adverbs_and_Other_Expressions Genki lesson-20 Vocabulary
<ruby>少々<rt>しょうしょう</rt></ruby>	a few seconds	Adverbs_and_Other_Expressions Genki lesson-20 Vocabulary
それでは	if that is the case,...	Adverbs_and_Other_Expressions Genki lesson-20 Vocabulary
できれば	if possible	Adverbs_and_Other_Expressions Genki lesson-20 Vocabulary
また	again	Adverbs_and_Other_Expressions Genki lesson-20 Vocabulary
～みたいなX	X such as...	Adverbs_and_Other_Expressions Genki lesson-20 Vocabulary
<ruby>申し訳ありません<rt>もうしわけありません</rt></ruby>	You have my apologies.	Adverbs_and_Other_Expressions Genki lesson-20 Vocabulary
よろしかったら	if it is okay (polite)	Adverbs_and_Other_Expressions Genki lesson-20 Vocabulary
<ruby>痛い<rt>いたい</rt></ruby>	painful	Genki Kanji_Practice lesson-20 痛,_最,_and_続
<ruby>痛み止め<rt>いたみどめ</rt></ruby>	painkiller	Genki Kanji_Practice lesson-20 痛,_最,_and_続
<ruby>頭痛<rt>ずつう</rt></ruby>	headache	Genki Kanji_Practice lesson-20 痛,_最,_and_続
<ruby>腹痛<rt>ふくつう</rt></ruby>	stomachache	Genki Kanji_Practice lesson-20 痛,_最,_and_続
<ruby>腰痛<rt>ようつう</rt></ruby>	lower back pain	Genki Kanji_Practice lesson-20 痛,_最,_and_続
<ruby>最新<rt>さいしん</rt></ruby>	the latest	Genki Kanji_Practice lesson-20 痛,_最,_and_続
<ruby>続ける<rt>つづける</rt></ruby>	to continue	Genki Kanji_Practice lesson-20 痛,_最,_and_続
<ruby>手続き<rt>てつづき</rt></ruby>	procedure	Genki Kanji_Practice lesson-20 痛,_最,_and_続
<ruby>相続する<rt>そうぞくする</rt></ruby>	to inherit	Genki Kanji_Practice lesson-20 痛,_最,_and_続
<ruby>会議<rt>かいぎ</rt></ruby>	business meeting; conference	Genki lesson-21 Nouns_1 Vocabulary
<ruby>環境<rt>かんきょう</rt></ruby>	environment	Genki lesson-21 Nouns_1 Vocabulary
<ruby>警察<rt>けいさつ</rt></ruby>	police; police station	Genki lesson-21 Nouns_1 Vocabulary
<ruby>事<rt>こと</rt></ruby>	things; matters	Genki lesson-21 Nouns_1 Vocabulary
<ruby>準備<rt>じゅんび</rt></ruby>	preparation	Genki lesson-21 Nouns_1 Vocabulary
<ruby>信じる<rt>しんじる</rt></ruby>	to believe	Genki Kanji_Practice lesson-21 信,_経,_and_台
<ruby>自信<rt>じしん</rt></ruby>	confidence	Genki Kanji_Practice lesson-21 信,_経,_and_台
<ruby>信号<rt>しんごう</rt></ruby>	traffic signal	Genki Kanji_Practice lesson-21 信,_経,_and_台
<ruby>迷信<rt>めいしん</rt></ruby>	superstition	Genki Kanji_Practice lesson-21 信,_経,_and_台
<ruby>経済<rt>けいざい</rt></ruby>	economy	Genki Kanji_Practice lesson-21 信,_経,_and_台
<ruby>神経質<rt>しんけいしつ</rt></ruby>	over sensitive	Genki Kanji_Practice lesson-21 信,_経,_and_台
<ruby>経営学<rt>けいえいがく</rt></ruby>	management studies	Genki Kanji_Practice lesson-21 信,_経,_and_台
<ruby>パリ経由<rt>パリけいゆ</rt></ruby>	via Paris	Genki Kanji_Practice lesson-21 信,_経,_and_台
<ruby>二台<rt>にだい</rt></ruby>	two vehicles/machines/etc.	Genki Kanji_Practice lesson-21 信,_経,_and_台
<ruby>舞台<rt>ぶたい</rt></ruby>	stage	Genki Kanji_Practice lesson-21 信,_経,_and_台
スピーチ	speech	Genki lesson-21 Nouns_2 Vocabulary
<ruby>政府<rt>せいふ</rt></ruby>	government	Genki lesson-21 Nouns_2 Vocabulary
ちかん	sexual offender; pervert	Genki lesson-21 Nouns_2 Vocabulary
<ruby>同僚<rt>どうりょう</rt></ruby>	colleague	Genki lesson-21 Nouns_2 Vocabulary
<ruby>文句<rt>もんく</rt></ruby>	complaint	Genki lesson-21 Nouns_2 Vocabulary
<ruby>留守<rt>るす</rt></ruby>	absence; not at home	Genki lesson-21 Nouns_2 Vocabulary
<ruby>番犬<rt>ばんけん</rt></ruby>	watch dog	Genki Kanji_Practice lesson-21 風,_犬,_and_重
<ruby>盲導犬<rt>もうどうけん</rt></ruby>	seeing-eye dog	Genki Kanji_Practice lesson-21 風,_犬,_and_重
<ruby>重ねる<rt>かさねる</rt></ruby>	to pile up	Genki Kanji_Practice lesson-21 風,_犬,_and_重
<ruby>貴重品<rt>きちょうひん</rt></ruby>	valuables	Genki Kanji_Practice lesson-21 風,_犬,_and_重
<ruby>置く<rt>おく</rt></ruby>	to put; to lay; to place	Genki lesson-21 U-verbs Vocabulary
<ruby>気が付く<rt>きがつく</rt></ruby>	to notice	Genki lesson-21 U-verbs Vocabulary
ける	to kick	Genki lesson-21 U-verbs Vocabulary
<ruby>刺す<rt>さす</rt></ruby>	to bite	Genki lesson-21 U-verbs Vocabulary
<ruby>触る<rt>さわる</rt></ruby>	to touch	Genki lesson-21 U-verbs Vocabulary
<ruby>捕まる<rt>つかまる</rt></ruby>	to be arrested; to be caught	Genki lesson-21 U-verbs Vocabulary
<ruby>包む<rt>つつむ</rt></ruby>	to wrap; to cover	Genki lesson-21 U-verbs Vocabulary
<ruby>殴る<rt>なぐる</rt></ruby>	to strike; to hit; to punch	Genki lesson-21 U-verbs Vocabulary
<ruby>盗む<rt>ぬすむ</rt></ruby>	to steal; to rob	Genki lesson-21 U-verbs Vocabulary
<ruby>貼る<rt>はる</rt></ruby>	to post; to stick	Genki lesson-21 U-verbs Vocabulary
<ruby>踏む<rt>ふむ</rt></ruby>	to step on	Genki lesson-21 U-verbs Vocabulary
ふる	to turn down (somebody); to reject; to jilt	Genki lesson-21 U-verbs Vocabulary
<ruby>文句を言う<rt>もんくをいう</rt></ruby>	to complain	Genki lesson-21 U-verbs Vocabulary
<ruby>焼く<rt>やく</rt></ruby>	to bake; to burn; to grill	Genki lesson-21 U-verbs Vocabulary
やる	to give (to pets, plants, younger siblings, etc.)	Genki lesson-21 U-verbs Vocabulary
<ruby>初めは<rt>はじめは</rt></ruby>	at first	Genki Kanji_Practice lesson-21 初,_若,_and_送
<ruby>初めて<rt>はじめて</rt></ruby>	first time	Genki Kanji_Practice lesson-21 初,_若,_and_送
<ruby>最初<rt>さいしょ</rt></ruby>	first	Genki Kanji_Practice lesson-21 初,_若,_and_送
<ruby>初雪<rt>はつゆき</rt></ruby>	first snow	Genki Kanji_Practice lesson-21 初,_若,_and_送
<ruby>初恋<rt>はつこい</rt></ruby>	first love	Genki Kanji_Practice lesson-21 初,_若,_and_送
<ruby>若々しい<rt>わかわかしい</rt></ruby>	youthful	Genki Kanji_Practice lesson-21 初,_若,_and_送
<ruby>送金<rt>そうきん</rt></ruby>	sending money	Genki Kanji_Practice lesson-21 初,_若,_and_送
<ruby>送料<rt>そうりょう</rt></ruby>	postage	Genki Kanji_Practice lesson-21 初,_若,_and_送
<ruby>放送<rt>ほうそう</rt></ruby>	broadcast	Genki Kanji_Practice lesson-21 初,_若,_and_送
<ruby>回送電車<rt>かいそうでんしゃ</rt></ruby>	out-of-service train	Genki Kanji_Practice lesson-21 初,_若,_and_送
いじめる	to bully	Genki lesson-21 Ru-verbs_and_Irregular_verbs Vocabulary
<ruby>着替える<rt>きがえる</rt></ruby>	to change clothes	Genki lesson-21 Ru-verbs_and_Irregular_verbs Vocabulary
ためる	to save money	Genki lesson-21 Ru-verbs_and_Irregular_verbs Vocabulary
ほめる	to praise; to say nice things	Genki lesson-21 Ru-verbs_and_Irregular_verbs Vocabulary
<ruby>間違える<rt>まちがえる</rt></ruby>	to make a mistake	Genki lesson-21 Ru-verbs_and_Irregular_verbs Vocabulary
<ruby>見つける<rt>みつける</rt></ruby>	to find	Genki lesson-21 Ru-verbs_and_Irregular_verbs Vocabulary
ばかにする	to insult; to make a fool of...	Genki lesson-21 Ru-verbs_and_Irregular_verbs Vocabulary
びっくりする	to be surprised	Genki lesson-21 Ru-verbs_and_Irregular_verbs Vocabulary
<ruby>昼寝をする<rt>ひるねをする</rt></ruby>	to take a nap	Genki lesson-21 Ru-verbs_and_Irregular_verbs Vocabulary
<ruby>連絡する<rt>れんらくする</rt></ruby>	to contact	Genki lesson-21 Ru-verbs_and_Irregular_verbs Vocabulary
<ruby>幸福な<rt>こうふくな</rt></ruby>	happy (こう)	Genki Kanji_Practice lesson-21 幸,_計,_and_遅
<ruby>幸運<rt>こううん</rt></ruby>	good fortune	Genki Kanji_Practice lesson-21 幸,_計,_and_遅
<ruby>不幸<rt>ふこう</rt></ruby>	misfortune	Genki Kanji_Practice lesson-21 幸,_計,_and_遅
<ruby>幸い<rt>さいわい</rt></ruby>	fortunately	Genki Kanji_Practice lesson-21 幸,_計,_and_遅
<ruby>合計<rt>ごうけい</rt></ruby>	sum	Genki Kanji_Practice lesson-21 幸,_計,_and_遅
<ruby>計る<rt>はかる</rt></ruby>	to measure	Genki Kanji_Practice lesson-21 幸,_計,_and_遅
<ruby>遅れる<rt>おくれる</rt></ruby>	to be late (る)	Genki Kanji_Practice lesson-21 幸,_計,_and_遅
<ruby>乗り遅れる<rt>のりおくれる</rt></ruby>	to miss (transportation)	Genki Kanji_Practice lesson-21 幸,_計,_and_遅
<ruby>遅い<rt>おそい</rt></ruby>	late	Genki Kanji_Practice lesson-21 幸,_計,_and_遅
<ruby>遅刻する<rt>ちこくする</rt></ruby>	to be late (する)	Genki Kanji_Practice lesson-21 幸,_計,_and_遅
<ruby>遠い<rt>とおい</rt></ruby>	far (away)	Adjectives,_Adverbs_and_Other_Expressions Genki lesson-21 Vocabulary
ひどい	awful	Adjectives,_Adverbs_and_Other_Expressions Genki lesson-21 Vocabulary
<ruby>安全<rt>あんぜん（な）</rt></ruby>	safe	Adjectives,_Adverbs_and_Other_Expressions Genki lesson-21 Vocabulary
めちゃくちゃ（な）	messy; disorganized	Adjectives,_Adverbs_and_Other_Expressions Genki lesson-21 Vocabulary
<ruby>～間に<rt>～あいだに</rt></ruby>	while...	Adjectives,_Adverbs_and_Other_Expressions Genki lesson-21 Vocabulary
<ruby>少し<rt>すこし</rt></ruby>	a little	Adjectives,_Adverbs_and_Other_Expressions Genki lesson-21 Vocabulary
とにかく	anyhow; anyway	Adjectives,_Adverbs_and_Other_Expressions Genki lesson-21 Vocabulary
<ruby>心配な<rt>しんぱいな</rt></ruby>	worried about	Genki Kanji_Practice lesson-21 配,_弟,_and_妹
<ruby>配る<rt>くばる</rt></ruby>	to distribute	Genki Kanji_Practice lesson-21 配,_弟,_and_妹
<ruby>配達<rt>はいたつ</rt></ruby>	delivery	Genki Kanji_Practice lesson-21 配,_弟,_and_妹
<ruby>弟子<rt>でし</rt></ruby>	apprentice	Genki Kanji_Practice lesson-21 配,_弟,_and_妹
<ruby>姉妹校<rt>しまいこう</rt></ruby>	sister school	Genki Kanji_Practice lesson-21 配,_弟,_and_妹
<ruby>受付<rt>うけつけ</rt></ruby>	reception desk	Genki lesson-22 Nouns_1 Vocabulary
<ruby>お嬢さん<rt>おじょうさん</rt></ruby>	"(someone's) daughter (polite)"	Genki lesson-22 Nouns_1 Vocabulary
<ruby>後輩<rt>こうはい</rt></ruby>	junior member of a group	Genki lesson-22 Nouns_1 Vocabulary
<ruby>猿<rt>さる</rt></ruby>	monkey	Genki lesson-22 Nouns_1 Vocabulary
<ruby>記入する<rt>きにゅうする</rt></ruby>	to fill in	Genki Kanji_Practice lesson-22 記,_銀,_and_回
<ruby>記事<rt>きじ</rt></ruby>	an article; news	Genki Kanji_Practice lesson-22 記,_銀,_and_回
<ruby>銀メダル<rt>ぎんメダル</rt></ruby>	silver medal	Genki Kanji_Practice lesson-22 記,_銀,_and_回
<ruby>銀世界<rt>ぎんせかい</rt></ruby>	land covered with snow	Genki Kanji_Practice lesson-22 記,_銀,_and_回
<ruby>一回<rt>いっかい</rt></ruby>	one time	Genki Kanji_Practice lesson-22 記,_銀,_and_回
<ruby>回送バス<rt>かいそうバス</rt></ruby>	out-of-service bus	Genki Kanji_Practice lesson-22 記,_銀,_and_回
<ruby>最終回<rt>さいしゅうかい</rt></ruby>	last inning; last episode	Genki Kanji_Practice lesson-22 記,_銀,_and_回
<ruby>回す<rt>まわす</rt></ruby>	to turn	Genki Kanji_Practice lesson-22 記,_銀,_and_回
<ruby>塾<rt>じゅく</rt></ruby>	cram school	Genki lesson-22 Nouns_2 Vocabulary
<ruby>書類<rt>しょるい</rt></ruby>	document	Genki lesson-22 Nouns_2 Vocabulary
<ruby>先輩<rt>せんぱい</rt></ruby>	senior member of a group	Genki lesson-22 Nouns_2 Vocabulary
<ruby>部下<rt>ぶか</rt></ruby>	subordinate	Genki lesson-22 Nouns_2 Vocabulary
<ruby>復習<rt>ふくしゅう</rt></ruby>	review of a lesson	Genki lesson-22 Nouns_2 Vocabulary
<ruby>無駄遣い<rt>むだづかい</rt></ruby>	waste (money)	Genki lesson-22 Nouns_2 Vocabulary
<ruby>免許<rt>めんきょ</rt></ruby>	license	Genki lesson-22 Nouns_2 Vocabulary
<ruby>予習<rt>よしゅう</rt></ruby>	preparation of lessons	Genki lesson-22 Nouns_2 Vocabulary
<ruby>夕食<rt>ゆうしょく</rt></ruby>	dinner	Genki Kanji_Practice lesson-22 夕,_黒,_and_用
<ruby>夕日<rt>ゆうひ</rt></ruby>	setting sun	Genki Kanji_Practice lesson-22 夕,_黒,_and_用
<ruby>夕刊<rt>ゆうかん</rt></ruby>	evening newspaper	Genki Kanji_Practice lesson-22 夕,_黒,_and_用
<ruby>用事<rt>ようじ</rt></ruby>	a thing to take care of	Genki Kanji_Practice lesson-22 夕,_黒,_and_用
<ruby>子供用<rt>こどもよう</rt></ruby>	for children	Genki Kanji_Practice lesson-22 夕,_黒,_and_用
<ruby>費用<rt>ひよう</rt></ruby>	cost	Genki Kanji_Practice lesson-22 夕,_黒,_and_用
うるさい	noisy; annoying	Adjectives_and_U-verbs Genki lesson-22 Vocabulary
<ruby>貧乏<rt>びんぼう（な）</rt></ruby>	poor	Adjectives_and_U-verbs Genki lesson-22 Vocabulary
ぺらぺら（な）	fluent	Adjectives_and_U-verbs Genki lesson-22 Vocabulary
<ruby>変<rt>へん（な）</rt></ruby>	strange; unusual	Adjectives_and_U-verbs Genki lesson-22 Vocabulary
<ruby>楽<rt>らく（な）</rt></ruby>	easy; comfortable	Adjectives_and_U-verbs Genki lesson-22 Vocabulary
<ruby>風が吹く<rt>かぜがふく</rt></ruby>	the wind blows	Adjectives_and_U-verbs Genki lesson-22 Vocabulary
<ruby>拾う<rt>ひろう</rt></ruby>	to pick up (something)	Adjectives_and_U-verbs Genki lesson-22 Vocabulary
<ruby>放っておく<rt>ほうっておく</rt></ruby>	to leave (someone/something) alone; to neglect	Adjectives_and_U-verbs Genki lesson-22 Vocabulary
<ruby>間に合う<rt>まにあう</rt></ruby>	to be in time	Adjectives_and_U-verbs Genki lesson-22 Vocabulary
<ruby>お守り<rt>おまもり</rt></ruby>	charm	Genki Kanji_Practice lesson-22 守,_末,_and_待
<ruby>守衛<rt>しゅえい</rt></ruby>	security guard	Genki Kanji_Practice lesson-22 守,_末,_and_待
<ruby>期待する<rt>きたいする</rt></ruby>	to expect	Genki Kanji_Practice lesson-22 守,_末,_and_待
<ruby>招待<rt>しょうたい</rt></ruby>	invitation	Genki Kanji_Practice lesson-22 守,_末,_and_待
<ruby>計画を立てる<rt>けいかくをたてる</rt></ruby>	to make a plan	Genki lesson-22 Ru-verbs_and_Irregular_verbs Vocabulary
<ruby>育てる<rt>そだてる</rt></ruby>	to raise; to bring up	Genki lesson-22 Ru-verbs_and_Irregular_verbs Vocabulary
<ruby>お願いする<rt>おねがいする</rt></ruby>	to pray for help	Genki lesson-22 Ru-verbs_and_Irregular_verbs Vocabulary
<ruby>賛成する<rt>さんせいする</rt></ruby>	to agree	Genki lesson-22 Ru-verbs_and_Irregular_verbs Vocabulary
<ruby>失敗する<rt>しっぱいする</rt></ruby>	to fail; to be unsuccessful	Genki lesson-22 Ru-verbs_and_Irregular_verbs Vocabulary
<ruby>徹夜する<rt>てつやする</rt></ruby>	to stay up all night	Genki lesson-22 Ru-verbs_and_Irregular_verbs Vocabulary
<ruby>翻訳する<rt>ほんやくする</rt></ruby>	to translate	Genki lesson-22 Ru-verbs_and_Irregular_verbs Vocabulary
<ruby>残業<rt>ざんぎょう</rt></ruby>	over-time work	Genki Kanji_Practice lesson-22 残,_番,_and_駅
<ruby>残す<rt>のこす</rt></ruby>	to leave	Genki Kanji_Practice lesson-22 残,_番,_and_駅
<ruby>残念<rt>ざんねん</rt></ruby>	regrettable	Genki Kanji_Practice lesson-22 残,_番,_and_駅
<ruby>心残り<rt>こころのこり</rt></ruby>	regret	Genki Kanji_Practice lesson-22 残,_番,_and_駅
<ruby>一番<rt>いちばん</rt></ruby>	the first	Genki Kanji_Practice lesson-22 残,_番,_and_駅
<ruby>番号<rt>ばんごう</rt></ruby>	number	Genki Kanji_Practice lesson-22 残,_番,_and_駅
<ruby>駅前<rt>えきまえ</rt></ruby>	vicinity; in front of the station	Genki Kanji_Practice lesson-22 残,_番,_and_駅
こんなふう	like this	Adverbs_and_Other_Expressions Genki lesson-22 Vocabulary
<ruby>自由に<rt>じゆうに</rt></ruby>	freely	Adverbs_and_Other_Expressions Genki lesson-22 Vocabulary
ずっと	for a long time; all the time	Adverbs_and_Other_Expressions Genki lesson-22 Vocabulary
そんなこと（は）ない	"I don't think so."	Adverbs_and_Other_Expressions Genki lesson-22 Vocabulary
<ruby>何度も<rt>なんども</rt></ruby>	many times	Adverbs_and_Other_Expressions Genki lesson-22 Vocabulary
<ruby>説教する<rt>せっきょうする</rt></ruby>	to preach	Genki Kanji_Practice lesson-22 説,_案,_内,_and_忘
<ruby>案内する<rt>あんないする</rt></ruby>	to guide	Genki Kanji_Practice lesson-22 説,_案,_内,_and_忘
<ruby>案内所<rt>あんないじょ</rt></ruby>	information desk	Genki Kanji_Practice lesson-22 説,_案,_内,_and_忘
<ruby>案<rt>あん</rt></ruby>	idea; proposal	Genki Kanji_Practice lesson-22 説,_案,_内,_and_忘
<ruby>提案<rt>ていあん</rt></ruby>	proposal	Genki Kanji_Practice lesson-22 説,_案,_内,_and_忘
<ruby>国内<rt>こくない</rt></ruby>	domestic	Genki Kanji_Practice lesson-22 説,_案,_内,_and_忘
<ruby>内科<rt>ないか</rt></ruby>	internal medicine	Genki Kanji_Practice lesson-22 説,_案,_内,_and_忘
<ruby>内側<rt>うちがわ</rt></ruby>	inside	Genki Kanji_Practice lesson-22 説,_案,_内,_and_忘
<ruby>忘れる<rt>わすれる</rt></ruby>	to forget	Genki Kanji_Practice lesson-22 説,_案,_内,_and_忘
<ruby>忘れ物<rt>わすれもの</rt></ruby>	lost article	Genki Kanji_Practice lesson-22 説,_案,_内,_and_忘
<ruby>忘年会<rt>ぼうねんかい</rt></ruby>	year-end party	Genki Kanji_Practice lesson-22 説,_案,_内,_and_忘
<ruby>海外旅行<rt>かいがいりょこう</rt></ruby>	trip to a foreign country	Genki lesson-23 Nouns_1 Vocabulary
<ruby>靴下<rt>くつした</rt></ruby>	socks	Genki lesson-23 Nouns_1 Vocabulary
<ruby>国際電話<rt>こくさいでんわ</rt></ruby>	international call	Genki lesson-23 Nouns_1 Vocabulary
<ruby>選挙<rt>せんきょ</rt></ruby>	election	Genki lesson-23 Nouns_1 Vocabulary
<ruby>顔色<rt>かおいろ</rt></ruby>	complexion	Genki Kanji_Practice lesson-23 顔,_情,_and_怒
<ruby>表情<rt>ひょうじょう</rt></ruby>	expression	Genki Kanji_Practice lesson-23 顔,_情,_and_怒
<ruby>情報<rt>じょうほう</rt></ruby>	information	Genki Kanji_Practice lesson-23 顔,_情,_and_怒
<ruby>情け<rt>なさけ</rt></ruby>	mercy	Genki Kanji_Practice lesson-23 顔,_情,_and_怒
<ruby>怒り<rt>いかり</rt></ruby>	anger; rage	Genki Kanji_Practice lesson-23 顔,_情,_and_怒
<ruby>喜怒哀楽<rt>きどあいらく</rt></ruby>	human emotions	Genki Kanji_Practice lesson-23 顔,_情,_and_怒
ただ	free of charge	Genki lesson-23 Nouns_2 Vocabulary
<ruby>面接<rt>めんせつ</rt></ruby>	interview	Genki lesson-23 Nouns_2 Vocabulary
<ruby>理想<rt>りそう</rt></ruby>	ideal	Genki lesson-23 Nouns_2 Vocabulary
<ruby>変な<rt>へんな</rt></ruby>	strange	Genki Kanji_Practice lesson-23 変,_相,_and_横
<ruby>大変な<rt>たいへんな</rt></ruby>	tough; hectic	Genki Kanji_Practice lesson-23 変,_相,_and_横
<ruby>変化<rt>へんか</rt></ruby>	change	Genki Kanji_Practice lesson-23 変,_相,_and_横
<ruby>変人<rt>へんじん</rt></ruby>	eccentric person	Genki Kanji_Practice lesson-23 変,_相,_and_横
<ruby>変える<rt>かえる</rt></ruby>	to change something	Genki Kanji_Practice lesson-23 変,_相,_and_横
<ruby>相互の<rt>そうごの</rt></ruby>	mutual	Genki Kanji_Practice lesson-23 変,_相,_and_横
<ruby>横書き<rt>よこがき</rt></ruby>	horizontal writing	Genki Kanji_Practice lesson-23 変,_相,_and_横
<ruby>横断する<rt>おうだんする</rt></ruby>	to traverse	Genki Kanji_Practice lesson-23 変,_相,_and_横
まずい	(food is) terrible	Genki lesson-23 Vocabulary い-adjectives_and_U-verbs
<ruby>雨がやむ<rt>あめがやむ</rt></ruby>	the rain stops	Genki lesson-23 Vocabulary い-adjectives_and_U-verbs
いなくなる	(someone) is gone; to disappear	Genki lesson-23 Vocabulary い-adjectives_and_U-verbs
<ruby>お世話になる<rt>おせわになる</rt></ruby>	"to be in someone's care"	Genki lesson-23 Vocabulary い-adjectives_and_U-verbs
おなかをこわす	to have a stomachache	Genki lesson-23 Vocabulary い-adjectives_and_U-verbs
<ruby>気に入る<rt>きにいる</rt></ruby>	to find something agreeable	Genki lesson-23 Vocabulary い-adjectives_and_U-verbs
なくなる	to be lost; to disappear	Genki lesson-23 Vocabulary い-adjectives_and_U-verbs
<ruby>悪口を言う<rt>わるぐちをいう</rt></ruby>	"to talk behind someone's back"	Genki lesson-23 Vocabulary い-adjectives_and_U-verbs
<ruby>比べる<rt>くらべる</rt></ruby>	to compare	Genki Kanji_Practice lesson-23 比,_化,_and_違
<ruby>比較<rt>ひかく</rt></ruby>	comparison	Genki Kanji_Practice lesson-23 比,_化,_and_違
<ruby>比例<rt>ひれい</rt></ruby>	proportion	Genki Kanji_Practice lesson-23 比,_化,_and_違
<ruby>対比<rt>たいひ</rt></ruby>	contrast	Genki Kanji_Practice lesson-23 比,_化,_and_違
<ruby>比喩<rt>ひゆ</rt></ruby>	figure of speech	Genki Kanji_Practice lesson-23 比,_化,_and_違
<ruby>化学<rt>かがく</rt></ruby>	chemistry	Genki Kanji_Practice lesson-23 比,_化,_and_違
<ruby>同化<rt>どうか</rt></ruby>	assimilation	Genki Kanji_Practice lesson-23 比,_化,_and_違
<ruby>お化け<rt>おばけ</rt></ruby>	goblin; ghost	Genki Kanji_Practice lesson-23 比,_化,_and_違
<ruby>化粧<rt>けしょう</rt></ruby>	makeup	Genki Kanji_Practice lesson-23 比,_化,_and_違
<ruby>違法<rt>いほう</rt></ruby>	illegal	Genki Kanji_Practice lesson-23 比,_化,_and_違
<ruby>違反<rt>いはん</rt></ruby>	violation	Genki Kanji_Practice lesson-23 比,_化,_and_違
<ruby>換える<rt>かえる</rt></ruby>	to change	Genki lesson-23 Ru-verbs_and_Irregular_verbs Vocabulary
<ruby>答える<rt>こたえる</rt></ruby>	to answer	Genki lesson-23 Ru-verbs_and_Irregular_verbs Vocabulary
<ruby>離れる<rt>はなれる</rt></ruby>	(something/someone) separates; parts from	Genki lesson-23 Ru-verbs_and_Irregular_verbs Vocabulary
<ruby>～顔をする<rt>～かおをする</rt></ruby>	to look... (facial expression)	Genki lesson-23 Ru-verbs_and_Irregular_verbs Vocabulary
がっかりする	to be disappointed	Genki lesson-23 Ru-verbs_and_Irregular_verbs Vocabulary
<ruby>我慢する<rt>がまんする</rt></ruby>	to be tolerant/patient	Genki lesson-23 Ru-verbs_and_Irregular_verbs Vocabulary
<ruby>世話をする<rt>せわをする</rt></ruby>	to take care of...	Genki lesson-23 Ru-verbs_and_Irregular_verbs Vocabulary
<ruby>同情する<rt>どうじょうする</rt></ruby>	to sympathize	Genki lesson-23 Ru-verbs_and_Irregular_verbs Vocabulary
パンクする	(tire) goes flat	Genki lesson-23 Ru-verbs_and_Irregular_verbs Vocabulary
<ruby>戻ってくる<rt>もどってくる</rt></ruby>	(something/someone) comes back	Genki lesson-23 Ru-verbs_and_Irregular_verbs Vocabulary
<ruby>優勝する<rt>ゆうしょうする</rt></ruby>	to win a championship	Genki lesson-23 Ru-verbs_and_Irregular_verbs Vocabulary
<ruby>悲劇<rt>ひげき</rt></ruby>	tragedy	Genki Kanji_Practice lesson-23 悲,_調,_and_査
<ruby>悲惨な<rt>ひさんな</rt></ruby>	miserable	Genki Kanji_Practice lesson-23 悲,_調,_and_査
<ruby>悲しむ<rt>かなしむ</rt></ruby>	to grieve	Genki Kanji_Practice lesson-23 悲,_調,_and_査
<ruby>調査<rt>ちょうさ</rt></ruby>	survey; research	Genki Kanji_Practice lesson-23 悲,_調,_and_査
<ruby>調子<rt>ちょうし</rt></ruby>	condition	Genki Kanji_Practice lesson-23 悲,_調,_and_査
<ruby>強調する<rt>きょうちょうする</rt></ruby>	to emphasize	Genki Kanji_Practice lesson-23 悲,_調,_and_査
<ruby>検査<rt>けんさ</rt></ruby>	inspection	Genki Kanji_Practice lesson-23 悲,_調,_and_査
<ruby>審査<rt>しんさ</rt></ruby>	screening	Genki Kanji_Practice lesson-23 悲,_調,_and_査
<ruby>捜査<rt>そうさ</rt></ruby>	criminal investigation	Genki Kanji_Practice lesson-23 悲,_調,_and_査
<ruby>元気でね<rt>げんきでね</rt></ruby>	Take care of yourself.	Adverbs_and_Other_Expressions Genki lesson-23 Vocabulary
<ruby>最後に<rt>さいごに</rt></ruby>	finally	Adverbs_and_Other_Expressions Genki lesson-23 Vocabulary
そうそう	You are right.	Adverbs_and_Other_Expressions Genki lesson-23 Vocabulary
そろそろ	it is about time to...	Adverbs_and_Other_Expressions Genki lesson-23 Vocabulary
そんな～	such...; that kind of...	Adverbs_and_Other_Expressions Genki lesson-23 Vocabulary
ものすごく	extremely	Adverbs_and_Other_Expressions Genki lesson-23 Vocabulary
<ruby>果汁<rt>かじゅう</rt></ruby>	fruit juice	Genki Kanji_Practice lesson-23 果,_感,_and_答
<ruby>効果<rt>こうか</rt></ruby>	effect	Genki Kanji_Practice lesson-23 果,_感,_and_答
<ruby>使い果たす<rt>つかいはたす</rt></ruby>	to use up	Genki Kanji_Practice lesson-23 果,_感,_and_答
<ruby>果物<rt>くだもの</rt></ruby>	fruit	Genki Kanji_Practice lesson-23 果,_感,_and_答
<ruby>感情<rt>かんじょう</rt></ruby>	emotion	Genki Kanji_Practice lesson-23 果,_感,_and_答
<ruby>感動する<rt>かんどうする</rt></ruby>	to be moved	Genki Kanji_Practice lesson-23 果,_感,_and_答
<ruby>感じる<rt>かんじる</rt></ruby>	to feel	Genki Kanji_Practice lesson-23 果,_感,_and_答
<ruby>感謝<rt>かんしゃ</rt></ruby>	gratitude	Genki Kanji_Practice lesson-23 果,_感,_and_答
<ruby>感想<rt>かんそう</rt></ruby>	impression	Genki Kanji_Practice lesson-23 果,_感,_and_答
<ruby>答え／答<rt>こたえ</rt></ruby>	answer	Genki Kanji_Practice lesson-23 果,_感,_and_答
<ruby>回答<rt>かいとう</rt></ruby>	reply; answer	Genki Kanji_Practice lesson-23 果,_感,_and_答
<ruby>答案<rt>とうあん</rt></ruby>	examination paper	Genki Kanji_Practice lesson-23 果,_感,_and_答